111111111111111
000000000011001
101111111000011
111101001111001
100000011101011
101011000001001
101001111111101
101100100001101
101110101011001
100110001001011
110011111101011
111001100100001
111100110111111
111110000000000
111111111111111
