11111111111111111111111111111111111111111111111111111111111111111111111111111111111111111111111
00000110100000000101000010000000101000000001010110001001100001000100001100000101001010101100001
11110010001011011100011000110101100011011101010000100011001101010101100110110000011000000101101
10011011011111011001111111110111001110010101000101111110011001010100110000111111010011110100101
10111001010000010011100011010010011100110001111101100011011011010110111111100110010110010101101
10101101110110110110101001011000110101111101100001001001001000010010001100001100110111010001001
10000100100011100110001100001111110100011001001111011101101111111011101001101001110011011111011
11011110101001101100100111101000100111001101011000010100101000001011001011001011011001001000001
10001100101100001001110100101010001101100100010011110110000011011001101011111000001101101011011
10101001100111111011000110101111011000110111110111000011111111001101001000100011111000101010001
11101011110001001111110010100001000011100110000000011000110001100100011010101111000010001011101
10001001011101100000111010111101010110001100111110111111100100111101111110100110010111111001101
10111100010001111010100010001101010010111001100011100011001110001000101000110100110100001100111
10010111010111000010110110100101111010010011101010001010011111101110100010010001111101100110001
11000110010001110110000111110101000011000110001110111010110100100010001111011111010000110011101
11101100111100100011111100010000010111110000111100100010010001111011101000000011000111100110001
10100101100110001110000001011010110100011110011001110111011011000001001111111001101100110100101
10001101001111011000111111001111100101001000110011000100011000011101101100001100101110000001101
10111001011100010011100101101000111101101110010111101101001111110100101001100111100110101101001
10100011000001110110110001101010100001000011010011001111100000100110101011110000110011111111011
10101111111111000110000100100010110111101001011001100011001110101100111010011110111010000110001
10001000010000011100101111111110000100111101001100111001101100101101110011001010101010110010101
10111011000111110110101010000111111110010001101110001100111001100100000111011000100010111011101
10001011111100000100101000110000000011010111101011100110011011110111110101010010101110001001111
11100010010001110101101011111011111010010000101001001111001000110010111100000111100011101100001
10111111010100011100101010011010001010111110101101011101101010011000011001111111001001000111101
10000000010111000110100011001000101000100100100001010001101111001111001011000110011011010001001
10101011110101101100111111101111101110001101110111010100100011100011101011101100111001011011011
11101110000100100101100000000000100011111001000100010110110110101010000000101001101100001110001
10001100111101110100110111101011110110001011101101110111110000101011111110001101101111011000101
10111001110001010110010000111001010100100010001101100001011110101001100011100100101001110011101
10100011000111000111011110001100010001111110101001001101000010111100001001110110001101000110001
10001110010110010101000010100111011111001010111011111000011010010111111101010111100001010011011
10111000110010110101111010101110010001100010011000001111001011000010001001000100111101011001111
10101010111110010000010010100100110100110111001111100001111011111000101011011101100101001100111
10001010000011011111010111110110000110010001101010101100011000101111100010000100110001011110011
11101111111001000100010000010011010011010100001000111111010010001010111111110110000111000111001
10000110000011110111011111011001111110011111101101100001011011100010000000110011010101110001111
11110011011011010110010000011101000011010000100001101101010010111000110110011001110000011100001
11011011001001010010110111110000011010000110111111001001011000001011110011011100111110110111011
10001001101101011011110010000111110011111110000000011011001111011000010111000110000010000011001
10101101001001001000011010111100011010001011111111110001100001001111110001111111111011101001101
10111101011101101111010010010001001011011000000000011100111101100100011100110000101000101100101
10000001010100000001000110110111101001001011101111000101100001101101001110000110001110100110101
10111111010111111101111111100101001101011010100001110100110111001001100010101100101010111111101
10011011010000100001000001001101011001001010111011000110010100011011111011101101101010000100001
11001000010110101111101100011001011101101010001001111111010111110010011001101001000011110110111
11101010110011101000111110111100010001001000101100100000010000100111001101001011010110000100001
10101110111001001010010100101001110111011111101101101011110110001101100101101001111100111101011
10100000101101011011000001101011100011000100001000101111011110111000101100101100001001110001001
10111111101001001111101111100010001001110001111010100110000100101010001110100110111011100101101
10000000000011101000100110001011011100111101100010110000110110000011100110110010001011001100101
10111110101000100010110011011001110110000100101111111111100011111110001100100111101001111101101
10100100111101111110111001111100100100110110100001011000111010000010111001110100101100010101001
10101101110000001010101100111110110001100110111100001110000010110110011011000001101111010101011
10001001000110100010000110011010011111001100100111100100111111100111001011101101100010010101001
11011011011111111010110011001011001000011101110101110101110000110001101000111000110110110001101
10001011110000001010011011101001100011110001100001000100000110011100001110010010010000100101101
10111010000111101011001110001100111110100111001111010111111111001111101011010111111101111111001
10101000111100101111100100101001100000001100011000010000100001101000100001011110000100010001011
10001011101110100000110101101101111011111111001011111011101101001010111101001100110111010100001
11011011000000111110010100101000110000100110011010010001001001011010110001101001110010010111101
10001110011101100010110101101010011110001100111010110111011011000010011011101011011010110000101
11100100110000110110010111001011001011011001100010000100010001111111001110001001001010100110101
10110111100110110011000100011001100010010011101111110101110111000011101100101100011010110110111
10110000101110011011111110111101110110110111001000011101010011011001101001101101110010010010001
10011110101011001000011000111100110100100100011011001101011001111100001011111001000111011011101
11000010001011101101010010011001100101110101111011100001001100111001111000010011011100010001001
10010111111001001001000111001111001100100100001001111111011110010011101110110110010110111101011
10110000101101011101111101100010011110001111101101001000000111010110000110100100110010010001001
11100110000001010000000001111011000011101001101101100011010010010000110010001101111011011111101
11001111111011010111111100100011010110101100100101001110011010111111111010101001010001000010001
10011101100010011100011001101110010000101110110101011100111010010001101011101011000111111010101
10110001001010110001001111001010111101100110010101010001110011000100101001101011110000011000111
10000111011010000111100100011000101101110011010001110111011011111110001101001000100101001110011
10111100001111111100110110111110100100011001011111100100010010001011011101011110111101100011001
10011001011100000001110100101100110111001101001011001101000110100000010001001010001000111011011
10110011010001101011010101100110010101100001100010011101111100111011110111101011101110101000001
11100110010100111000010001110011010001111111001000110101001001100010000101101010001000001111111
10001100110111100011011111011011010100000101111011100001011011111110111101000010111111111100001
10111001100011001110000011000010011111110001000010101111010011000010000001101110100011000101011
10011011101110011011101110011010110001100100011110001101010110011011111101000110001000010001001
11001000100100110010000100110010000100001111110100111000010000110000011001110011111111111111101
11101011110101111000111101100111111111111000110001100011011111100101001011011000000010000000101
11001110000100011111100000101100011000000010100111101111000100101111111010001110111110111110001
10011100111111000010001111100001010011111110101110001001110001100110001010100010100000100111011
10111001110001110110111000111011110111000110100100111100010100110000100010110110101011101100001
10101011000101010110100010011001000100010100110001100101111110111111111111110000101110001001111
10100011101101010000110111001101011101110001111111110100011010001000001000010111101100101011001
10001010001000010101100001101101010100111100100010110101001011101011100011010001001001101011101
10111111011111011101110101111001010110100001101000000101100001101110001111010111011011100001101
10010100001100001111000101010011000010111111001011101101111101001100111010011100011010111111001
11010001111001100110011101010111110110011000011001100000001101011001101010111001110000100001011
10000101000011110000110000010000000011000010111100101010100100000011000000000011000110001100000
11111111111111111111111111111111111111111111111111111111111111111111111111111111111111111111111
