111111111111111111111111111111111111111111111111111111111111
000010000001101010101010000000001000000011010001000000010001
101010101100101000000010101101111010101000011101010101011011
111011111110001011011011100100110010111101000100011101001011
101001000100100010010000110110010110010111110111110001101001
101100010111111110111110010011010111000010010001000111101101
100111110000110000100111011010010011111010111100011110100101
101100011110100111110101001010111010001010001111110000110001
100110110010001100010001101110010010101011100000000110111101
110000110111111001010101001000110110111001101101110011100101
111010010011000011000101011101100100011100111100011111001101
100011000110011010010101001001001101010110000110111000011001
101010010100111011111101101011011001000010110010010010111011
101010110001101001000100101010010011011011111011000110000001
101011100101000011010111101010111110010010001011110011111111
101000101111111110010000101000001000110110101000011001100001
101110100100001100110110101110100010011110101011011100110101
101010111101100001111110100010111110110000101110010110010111
100010100001111111101000111011110100100111101000110011010011
111110101101000010100010001000010001101110101011110110011001
100010100111111000101111101111011011001010101010000100111101
101000110010001110100001100001001110011000001011101101100001
101110111000100010111101001111100111001101111001000101111101
100100101111111000101001011000110101100100001101101101010001
110101100010001110001011110010000100110111101001000100000101
100101001010101011011000100111011110000110001011011111110101
101100011000100010001101101101111011110010111001000000111101
101111010010110110101000101100110000111010101101011110011001
100011011111110100111010100110000110010010000001000011010011
101001111000100101110010110111011111010111111111111001000111
101100100010101101000110010100010000010001000100001101101101
100110101110111001011110110110110111111100010001011111001101
111110101010100011011000010000100110000111110101000110011001
100000100010101110010011111111101100110000011111011100110011
110110111010101011010111010001001001111111000011011001110111
100100001010101001010001010101011101000001111001010011000001
101110101010001101011100010100010001101100011100010110011101
100011101011111101000111010111111100100111000111110111000101
101011001011000001010100010010001110110011110100100101110101
101001101010011011010110111010100100111000010001101100000101
101100101011001001110011100010110001100011011101101111011101
101110111001101100111000001110011111001111001111000110010101
100010011101111110001111111011010110011101100000011100110101
111111000100011011100110000000010010110000111111110001100001
100011101111000000110000101111011010100111110000000111101111
101000101001111110100101111100010010110000010110110100001011
101110000011100000101111000001110110011101010011100111011001
100011111010110111100011011111000111001001011001110010001101
101010101010100100111001001001010101101011001100111011101101
111010100000101110001101101100010001001011101110001001000001
110010101111100110101001001001111011011010100010111101111101
100110001000110011100011011011101001010010111010011001011001
101111101010011000111110010000001100010110000011001011000011
101000111010111110000000111111100111110111110111111010011111
100010110010000011111111101010110001100000100000110010110001
111010000111111001000010100000010100101110111110010110000101
110010111100001101011010001111111110100100100011010111110111
100110110110101100001000100010001010111101101010000101100011
101100000000100101101010101000100000000001001000110100001000
111111111111111111111111111111111111111111111111111111111111
