1111111111111111111111111111111111111111111111111111111111111111111111111111111111111111111111111111
0001001010011000000011010101010100000010000011010000010100001010101000011001100010000110000000110001
1011100000110011011001000000000101111011101001000110110001100000001111001100001000101100101110000101
1001111101100111001101110111110100110000111100011110100111111101100011100101111011100111101011111101
1101010001001101100100110000110110100110000110110000101110000101111010110001100010110000001010000101
1101000101011100110110011110100010111111010011111011101100111101001000011011001110011111111000110101
1000011101000001100011000000101010000011111001000000000001100001011101001110011010111000010010011101
1111110001110100111011111111111010111001101101011111110101001111011001100100110000010011000111010001
1010100111010110011010000010010010011100101101111000100111011000010011110001110111010111101100010111
1010001100000011001000111011010111001110100000100010111100010010110110011111100001000000101111110001
1010111001011111101111100011010011111000101010001010000110110110100100111000111011111101100000011101
1010101111110000100001001110011001100011111111101111110000100100101101101010011010001000111111001101
1010101000100110111111011000111100101010000010000100011111101101101000100011001110101010100001100001
1000000010110010010000010010000110101110111011111101000011000101001011101111100010101110101101111111
1011111110011011010111111011110010101000011000010001111001011100011000100110111000100010001000001101
1110000011001001000100000000111110100010110010110111011101000101111101110010011111111011111111100101
1100101001101101111101111110000110111111100110010010000101111101000001011011010101000010001000110101
1001101111001100010000100011110000000000111100111011110100001101101111000010000101011110101010000101
1011100001101001011111101000100111111110000110001001100111101000100011011110110001001011101011111101
1010111100001011001100001010101100100011110011101100101100101110111010010000100111101001001000110001
1000010111011011100001111110111001101001011001000110100001100100001010111011101100001100011110011101
1111010001111010111111000010001011001100011101010000110100110111100010010001001001111101000011000101
1000010100110010000110011010101000011110110001011111100110010000111111011101111011000001111011110001
1101110110100110101100110010101011011010110111000000001111011110010001001000110001101111000000011101
1000111110101111100101110110101110010010000011101111111100000011000101101110100111000011111111110101
1110100010100110001101010100100100110111111110100100000101101111111100000000101100011000000000110001
1010101000101100111001000101110101100010000000110101110111000100001111111111100111011111111110010111
1000101111101001110011011101100101001011101010010101100001011101100011000000110110001001100011000001
1011100010001011100111011000101100011000111011011100111101011001111000011110100010101101001001011111
1001101000111010001110001111101111111110110010000110001001110011011111111000101011100000011011110001
1011001111100010111011100011001000011010000111110011101100100110000000001110111000111011111110000101
1001100000001010001010111000011011000011111110011000100110110011101110100100001101110010000110111101
1100111111101011101000101111110001101000011000111110110100011000100110111101100100011010110000001101
1110000000111001001010100000110100111111000010101010010111001010110010000000110111010010011111100101
1111111110001011011011101110000110010001111110100011000101101110111111111111110100010110110000111101
1100000011101110010011001011111111000100110000101001111100000000100010000000100110111100100110010001
1001101110100110111000011000110001111110011101101100001101111111101000101110101110011001101111011011
1011100110110100100011111110000100000011000111000110100101100000101111111000100010110011101010010001
1010110010100101101110100011111111101001010000010010110101001010001001000011111010010111001010110111
1000011010001100100100001001000110001011111110111010110101011111111101011111001011000010011010110001
1101111010111110110101111101010100111010000011110010011101000101100001000010011011111110110000100101
1000100010010100110101001001010001101010111001100111001101110101001101111010110001100010100111111101
1110101111010001100001011011011101001010101100111101100001000100011100110010000100101000110110000001
1000100011011011110101001001000111011010000110000101111011011101110110010111111110001111100011010101
1011111001011000011111101101010001010011110111110000001010011001000011010100000011111010111001110101
1010001100010011000010100101110101010111010101011111101010110011010111010001111000101000001101000101
1010100111110111011000110000111101010110010100000011001010000110010010011111101110100010101001011101
1010110000111100011110011010011001000000110101111010011111111100111010111000001000101111100011000101
1000011110001001110011001111000011011111100100001110110100011001101110001101011011101001111110010111
1111111011101011000111100111101011110000101110100010000001001011000011101001010010000011000111010001
1000110001001010010100110010001110000101101010110111111111100010011001001101010111111001010010011011
1010000101011000110101111011011100101100101010110000001000101000111100011101010101001100011010110001
1111011101001011100100001001110001111001101000010101100010111111100111111001010001101111111011100101
1100010001101110001111101100011011011011001111110111101110010100001100000011011100100010101001001101
1001010111000100101000000111010010001000011000010010001000110001011001111110010110111000001101101101
1011110001110111101110101100010111101111111011011010111011100101010011001010110010011111011000100101
1000011100110000100100111001010001000000001010010010011111001101000111101000000111010001001110111101
1011001110011110110001110011111101011111100010111011000110011001111110001011011101000101100000001101
1001100111001000100100100110000001010001111110001110010000111011000000101001110001110100101111100101
1101110001101011101110101110111111000100001011100010111111110011110101101011000100011110101100110101
1000111101101000111100100010000001011111101000111010011000010110000111001010011111000000111001100101
1110100001001110000110111011111101000001101011110011001110110011101110011010110001111111110011101101
1000101111011011010010010000001101110100101010000111100100011001101000110010000101000000000110001001
1101101100000001111011010111101001000110101010111100110101011101001011100111111101011111101110111101
1000100110111100100011010000111011011111101000100001100001000101011110001100011001111000000010011001
1110110011101110101110010110001010001001001011101100111111110101000000111001001011000011111011000011
1000011000100000101100110011011011100011011001000110100000000101011111100011101001101110001111111001
1111110010101111101001110110001001110110011101110010001111111101001001001110101100100000100000011011
1100011110111100001011000011101100100100110100111111111100001001101011011000100110101111111111010001
1001001100110001111111111110000110111101110110000111000001100011100010011110110000100100000101010111
1011100001100101001000010000111110011001000011010010011111111110110110110100011111110110110001010001
1000111111001111100011000101100011001011101111011000110000000110000100100001010001000100011101011101
1010010001011010110111111111001011100011000001111101111111010011011101111011011101011111010001000101
1011000101011000000110001010011000111010010100110001000001111010010001000010000001000001011111011101
1001111101001110110000100010111101101111110110011101011100011010110111010111111101111100010000010001
1101010001100011110111111000100100000110000011001001001001001010010110010001000001101001010110110111
1101010111111001100110011111110111010010111001111011101011101011010011010101111100100011110100100101
1001010100001100110010110000010001111000001100100011001110001001011001110100000110101110100101101101
1011010001100110011010100101000100101111100111101110011100111100001100111110110100100110101101001001
1010010101101111010000101101101110000000101100000110110101110111101110100011100101110000101101011011
1000111111000011011110111001001011111110100001111100110100000001111000101000110111011101100101011001
1101100001010110010010011111011000000110111111000001100111111100110011101010010110000100110111001011
1001001100010010111011000000010011011100100011011111001100010110100110001111010100111110010011101001
1011011111111010110011111111111001000001101010010001100001000010001100100110000001100000111010101101
1001011000010010010110000010001101111111111010111011110111111011111110110011110101001111100000100101
1101001101000111010100110110101100110100000010101000010000011000110100011001100111011010001110110101
1001100101111100010101100100100110010101110110001011110111001110010101001101001110010010111000010001
1011110101010001110101101101110111010001100011101000100001101011010001111001011000111010011011011101
1110000100010111000000100000010100011111001010001010001011101011011100110011011011101011001111000101
1000111111010011011111111101010001110000011010111011111110001001000111100110001001000001100110010101
1101100100011001000001000111111100000101001110100000010100111101110000001100111101011100110011011101
1001001101111101111011010100000110110101111100110101110001110000111111111001100001011001111001111001
1011101000010100011110010101110010011111100001100111000111011010011000001100101111110011101100001011
1001100011000111010100110101011011110000101111101110011100010011010010100110100011000111001110111001
1100110111110110010001110001010010000110001001001010110101010111000110111100101001101100011010001101
1110011101100100110111011111000110111111111100011010110001000001010010000001111100000110110011011001
1111001000111101110100010000011100100110000001110010011111111111111011111111010111110100000110011011
1100011010001101000101010111110001110010111111100111001100001100001111000100000010110111101110110001
1001000010100000010101000000000100011000000000001111100001100001100000010001011000000000000010000100
1111111111111111111111111111111111111111111111111111111111111111111111111111111111111111111111111111
