111111111111111111111111111111
000100000011000001100010001101
100111011000011111001000100101
110001011101011000011101110001
111101010001110011110000011101
100101011111000111010111110001
110101010000011100010000011111
110001000111110001011111000011
100111101110100101000011111001
110100100000101101111110001101
100101111110001111000000101101
110101010110111000011111100001
100100000100011011111000111101
101111010001110010000010001101
100010010100100110110110111001
111011011111101111100010100011
101001110001101011001110001111
101101000100001010011011111101
100001010111111010110001000001
111011010100010010000101011101
110010011101011011111101000101
100111000001010001101101110101
101101010111010100101001000101
100001110110010110100011011111
111100011100111110101110000011
100111000001100000100111111001
110011111111001011110100001101
100110001010011000010001100001
110000100000110011000100110100
111111111111111111111111111111
