111111111111111111111111111111111111111111111
001000110101000010000000011001111000010010101
100010010001111000101111001100110011011000001
111111010100001111100001101110000110000011101
110101000111100001111101001011101100111111001
100001110100111100011001011000001001100010011
101100011110001111000011011101011011101010111
100101001100100011111111001101110011001011101
110111100110111110000001100101100110011000001
110000110010100010111100110100111100110010101
100110011000101000100110000110110001100110111
101111001111101111101111111100000100111110011
100011100110001100001000000110101101100011001
111010110010111001100011010011101111001001101
101000111000011011101110011000111000011101001
101110011111110000111000111110110011111101101
100010110000000110100011100010000110001001001
101110010111011100101111001011111110101011011
100111011110001101100010011000100000101001001
110101001100100111101010111111101101101101101
100001100110110011001010000000000100111101001
101100110010011001111011011111111110011001011
101111111010111111000010011010000011001011011
100000101010011000011111000011010111100010001
101110001011010011110001111001110000111111101
101010111010010110011011101100011010110101001
100010011010110111000000000111011010010000011
101111010010110101101111110101001011011011001
100101000111100100001000000001101010010011011
110101111100001111011111101101101010110110001
100001001111011100011000111000100010010100101
111101100000010001010010011101111111010101101
110101101010110111110111000111000000010111101
100100111010100000100101110110011111110011001
101110011110110101101100010000110101011001101
100011010000100100100111011111110000001100111
110110010111101110101100011000000111101110001
100110110100000110100110110010111101101011011
110100100101111100110110100110010000100011001
100101110100110001100000111111011110110110011
101101000110010111111110000100010000010000111
100101110010110000100011110110111011111110001
110100011010011011101010000000101011000111011
100001000011001000001000101010100000010000000
111111111111111111111111111111111111111111111
