1111111111111111111111111111111111111111111111111111111111111111111111111111111111111111111111111111111111111111111111111111111111111111111111111111111111111111
0000110000001000000110000000110000000000100000110000101010100011000000101011000000001010100000011000110000100000100010100000011100000000110001000000010000001001
1110100111101110110011011110100101101010001101100110000000001000011101100001011111111000001011000010100111101010111000001101001001111110100100011111011011101101
1010101110100110111001110000101101101111111100111111011111111111110100101101000000010011111111101110001110001010001111011001101100000100001111111000000010101101
1010001000110000101101000110111000100100010110100001000001000000010110100101011111000110000100001010111010111010100001110011100111110101101100001111111110000001
1011111101111111100101101100011010110111000010101101011101011010110000110100010001111111010111101000100010110011111101000110110000100101000110100110000110111101
1000000101100000110101001001001110010011101110100101111001010010100111110111111011100110010110001011101000100111001001011100111110111101101100110010110011100101
1011110101001010000100011101100011111010101100110100001011010110101100010010000010110100110010111000101111101101101011001110001010001001000101111000111000110001
1010010100011111110110110111110110000010001001110110100010010010101110111011101110000101111000100010101101100100100001100010100011101101101101001111101110010111
1010110101110000100011100011010011011110101011010111111110111011101010101001100010101101111111111111100100110110001111111010111000100101001001100100000011010011
1010000101000110001001001000011001001010111001000001101100011001101000101101001000100100110100011000110110010010111101000010011101110101111011101101101011011001
1011110111011111111101011101011101101000001101110100100001001101000010001101101111110110010001000010010010111010100000011111010100000100001000101000111010011101
1001100001000101010001010001010001001011101100011110110111101101011111100100111000010111000111111111011010100010001111111000010111111101011110100010011010110101
1100111101110100010111110101110111101000100111001100010000111001001000110110011101000101111100000100001000101111011000001110110000000101000000111111110010010101
1110101001100110110100000101000110001011110001101001011101100011011010011111000101010000010111101101101110100001110010100100011011110111011010000000010111010101
1000101011001110100101101101011100111110000100101101000111001010010011000001110101011111010000001101111100110111100111110110110000010010001111111111000101010001
1101101010011000101101001001000001100000101111101001101100011110110111111100010101110001110101100100100001100001001100010100010111011011111000100101110101011011
1001001000110010100101011101111111110101111000001011000110111000010100011001110101100100000100101110001111111100011001010111010100011000000010110000010001001011
1011101111110110110111001000000100100100110011111001110110100011110101010011100100101111101110100011111001101111111101000101010101001111111110011110111101101001
1000101101000100010011101111110001101110010111001101010010001011010101110111001110000000111010111010101100001010100001111101011101111000000111000110100001001101
1110100000011111011001001000011011001011010101011101011011011000010001000100011100111111100010101000100110100010101111000001000100010011110101110100101111011001
1000101011110001001100011011000010011001010100010001001001001111111011011101110001100011001000101110110110111000100110011011110101010111000100010101101001001101
1011101001100101111111110001011110111101000101000100011101111000001001011000011111001000011010100000000100101101110011001110000101010110011101010100001011100101
1001101100001100010001010111010000110001111111111111010100100010101101000011001100011111001111111111110001100000011001100100111101000100110001010110100011110101
1101000111111111000100000001110111100100110001100001010101101110111101111111100101110001011100001100010100111111111100110001110101111101100111110011111001100101
1101110001000011010111111101000110111110000101001101000100100110011000011000110101000111010001100001011110011000110110100111000111000001001100011001101100110101
1001011101011001111110001001011100001011011100011001110110110011000011110010100001010110010111111111001011010010010000101110010011101111101001001100100110100101
1011000001001100000100101111010001101000010111110011010010111011111110100110111111110000110000011001100001110111011101101010111000001000100011011110101100101101
1010010101101111110101101100010111101110110000010110011010101010000000101110110101100111111111001100111100000100011001001000101111111110101110001100101001101111
1010110111101000010000100001110100100000100101010111000010001011011111101010010001001100001001100110000111111110110011101101100001010110100111100110100011000001
1010111100001101111111111111000101111111101101110011010110101001000100001011010100011111100011110110110100011000100110100001001111000010110010110000101111111101
1010100001111000000000000011101101100010000100011001110100101101101101111001010111111000110110000100011101001101101100111111100011011000011000011111100011100101
1011101111101110110111111010001000001010111111001100100101100100000101000011010001100010010100111101110001100001001110001010001000011111001111000011001001001101
1001001000000010010001100010101111111010001000011110101100110110101101011001011100001111010101101100000111111111101010101000111111110001100011111001111100011001
1100011111011011010100110110101100000011011011011000100110010100111001001101001111100110010100101001111110000000001000101011101010010100111001011100001111011011
1001110100010011011110100110100101111110010001110011110011011101110011100101100001110011000110101011100000101111111101101001000011010110101100000111011011001001
1011000001111010001010110010110100000010110101100110011110010001000111110101111101011001111100100000110101100110001100111101011000010010001111110011001001101011
1001101111100011101010011010110110111010010100101111000111000111011101010101000100011100110001111110011111110000100110001001001101111011100000011001101101101011
1100101010101110100011010010010100100011010111101111010011111110010000000111010111001111100101000111000000100111110010101011011111000010111111001100100101001001
1110101010001000111001010111110101101011010000100110011010000000111011111110010001101000001111010001111110101100011011100010011000011110101101100110110100011101
1010001000101010110011010010000101001110010110101100110010101111101010000000111101001011100110011101100010100001110011001110110011110000001001001100100111110101
1011111011111010011010011011011101011100110010100101100111101010001000111111110101011000111100110101001000110101100110011000100111011011100011011001101100000001
1010101000110011010010110000010001000001111010110001001100001010100011110000000101001110110001110101011110111111001100110010001100001010001110001011000110111101
1000001110011111000110011111111111111111111010011111011111011000101000010101111101101100100111000101111100100001011101110111111101100010100111101001110010100001
1101011011000001111111010101010001100000110011000110000010001111111101000101000000101001101100010100011001110101010101100100000001111111110010001100011000101111
1001110001110100001100010000010100101110011001010011111011100100001111110101011011101011100101011111010011100100010100110111101011000001100110101111011111101101
1011000100011111100001111011010110001011001111011000011001110001100000111101001110001010110001011000011011001111110110010000111000011101001100100110010000001001
1001011111001000111111100010000111111011100010011101001101011011111010001001011100111000111111010011110001011011000111011110010011110001011101101100110111111011
1011010101100010110000101111111100011000111010110001100100010010001111101101011001110010010000010110000100010000010001000111010110010111010100101001110100110001
1001010000110110010101100010101001001010000000100100111111011010100101001001000011010111010101010111111111010111111101110100010000110011010110111011100110011101
1101011110100111000111001010001011100011111111111110110000010010110100011011111110000001000111110100000011110110000100110101111110011010010010001000001111000001
1001010000101101110010011010101001111000000100001000010111110110011101111001010111110111111100000101111001100011101110100101100000110011000111101111111001101101
1011000110100100010110110010101100001111111101101111110001100000110001001101000100010100011001110100101100111000100100101100111110011001111110101000001101001001
1001111110110111000100011010101111101000001000100000011011001101100111100000010001011101000011100110000110001110001101101110100011001100000000100011011000011111
1011100100010011101101110010100010001011101011111111000010011000101100110111111111000101111110101111010010100111100100100110001001101111101101101110010011110001
1000101101111000101100110110110110111001001010000011111110111111101110100110000011110001000000100101011111110101110110110011111101000001100111001010110111000101
1011100001001110111001100100110010001101011010111010000000100001100110001100101010011111101101110001001000000100100010011001100101111111001110011000100100011101
1011001111011010001011001101100111101101001010010010101011101100110011111001111011000101000100011011101010111110101111001100110000110000011000111101110001111001
1000011011000011100010011000101100000101100011010111111001000110011000011011011001010000011110110000101010100010000001100110011110000101111101101001011111100011
1011110001011001111110111011100101111100111110010000011111011111011011010010001101111011110010000110101011101011111101101111011011010101000101100011000011001001
1000010100001100000110110000110001000001100010111111000010000101001001010111100100001000010111111110101000001001010100101011001000011111010001001111101000011101
1111011110100111110010011010011111011111001000100101111011110101101111000000001101101111010000000011101111111101000110100001101101110001011111101010101111111001
1001000011110000111111001011010001001000011101110000001011000100000001111101111111000100010111011110001100001001101110110100100111000100010000001000001101001101
1101111001111110000001101110011011101111111000110111101001011101111100000111000011110110111100010000111001101011000010011101110011101111110111111110111000011001
1001011100100011110101100011000001101100001110010000101101001111101111110000011000110100100001110111101111001001110111001000111010001000010010000000100011011011
1011000110101010000100111001111100100101100011011111100101100000100000011111111110000101101101000100000001011101000101101010100010111110111011110111110110001011
1010010010101000110110011101000110110101001000011000110000101110111101110000000111111101000111011111110100010101011100001011101110100000101001000100000110111001
1000111000101011110011000100010011100101101111110010010110100010001001100111011100001000011100010001000110110001001101111000101000110110001101011110111100011101
1011101111101110100110011111110110001100111000110111011100111011101011001100011001100011001001110101101100010111100000001110001011110011111101000110110001110001
1001000110000010001100110000000110111110000010010110000110110001101001011101110011111111111011000101001001010000111111100111111001011000001001010010011101100111
1101011100111010111001100111110100101010111111000011110010011011001101010100010110000000100010010100011011111110000000110100001101010011100011011011000111001101
1001010001110010110011101110000101100000000101010110011011001010011000000111010111110110101111010111111010110010111110100001111001000110111110011011110110011001
1011000101010111100110001000111100111111110101110000110011101010111111110010010000011100101010010000110010100111100010101100110011011100011011110010100100111101
1011111100010001001100111101100110000100000100111111111010001010001100010110111111011001101000110110011000001100001000111110010110010111010000000110001101110001
1000001111011101011101100101110011110110101110100000000011101110111001010010001100001011101011100011001111100101011101100011000100110000000111111100100101000101
1111100110010001001001110000011000010011101110101111111111000100010011011111100101100000101000111001100010110101110001001011111101111110101100010110110101011101
1000110011010111101011000110110011011001000100100001000001110111000110011000110000111111101110011111001010100101100111011001000001011000111001000000100100010101
1010011001110010111011111100000110001101010001111101110100010001111100110010011111100000100100110001101010001100101110011101101011000011110011011101111111110101
1011001100011010001000011001010100100101111101000100100110111100010001100111000000001110110111100100111010111110111010110100111011101110000110001001010001000001
1011100111001000101111001011111111111101101001101110110110000111011011001110011111111010100110001110000010010110110000100110011010000110111110101011000100011111
1010110101101011100001101110100001000001001011100010011100110101001000011000110000000010101100111011111111010010010111101111010010110011100011101010011111111001
1010000000101001111011100000101100011111011010001011010001110001101111111101111011101110100001100011000001011011000100001010010110111011001000111010110000100011
1011111111101100011000110111101111110000001011011110010111011100100000000100110010000110111111101000010111010001111110111000110100001000011010001000110110001011
1001100001101110110010110100001000111011011010010000110100010101111111110110010111010100010010001111110001000101000010100011100101101010111011101011100100111001
1101001100001011100110100101111010001011110000110111100110110000100001100111000101011101010110111000111101111101011000101111001100111111100011001010001101101101
1001011111111010001111101100010011101000000111100100001100100111101011001101111100010001000010011010100000101001001111101000011001100001101110011010111001001101
1011010110011000100010001111010110001011111100001101011110101101001001011000100101110111011011001010111010001011100110001110111111001100111000110011100011100001
1011000100110011110110100011000110111001000110111111001000000001011100010010001101000100001111101010001011111011110010111100010100011110000010110111001111001011
1001110001100110100100101001111100100011010010100001101011011111011111111011100001011101011000001011100011000001111010011001000101110011111111100100011000011001
1100111011001110101101101111100101111110011000101101101110000100001100001111001111001001110010111010001110010100100011001011110100011000000101001110111111111101
1110101010011010000100111000110001000010111111100100001100101101111001100001101001101100100111110010111000110110001001101110010110110010110001011000100100001001
1110001000110010111101100010010111011000100010110110100110111001000011111100100011000110101110000110100010111111111100100011010010100110011111010010001101101101
1100111111111000110101101111010100011111101000100100110011100011110111000110111111110100100011011110101110011000010110111010011000110011010000010111111100100101
1001100000001011100100001001000101000110001110001111111010001110100110010010001000100110110110010010100011110011010010010011001111100111010111110110000110110111
1011001101101010001111111101111101110010100011011010001110111000001100111011100010110011100100110110111001000111010110110111100000110100010101100100110010010001
1010011100111010111100000101000100011011111010010000100000100010111001101001111110111010001101100010101101011101010110100101001110000101110100001101111000111101
1010110110000010011001010000010111011000001011010111111011110111101100101101001100101010100101111000001001001000010000101101011011111101000111011100011110000101
1010010011111111000011011111011101001011101001110100001111000101001110100101011001100010110100011101111011101011011111100101000011010100011110010111010011111101
1011011001100001011111110001000101101111001101000101100110010100011000110000010011001110011111000111100010101110011000110101111001000111110010110001010110000101
1001010011001101011000110101010001000110011101011111110000111110110011100101110111100010110001010011001010100011000010100100001101101101011000100100000010110001
1101000110011101010010000101010100011100111001010000011101100010000110101111000101101000100101111000011010111001111110110101100100001000010010001111110110111011
1001110010111001010111111101110111011001100011011011001101001011101100000010011101001111101100001111111000001101000010000100111110101011000111111000011100101001
1011011010110011110100000100100001110011110110010011100100011010001001111110110000011001100111100010001111111001011111111110001011101110010100010011000001101101
1010000010011000000101110110101100110110100010111000110110110011011011000100011011111100110001111000100100011101000011000010100001001100111101011011111111001001
1000111111001111111101010000111111100100001010011110010011100110010010010001110001100110011100011111110001000001011010011010111100011001101001000010100001101011
1101100011101000100101011111100010001110111011000011011001001100110110111111011100110111001111010000111111111111010000111010110111110011001011111110101100001001
1000111000001010001101011000001000111000011111111010011101101110110100100011000110000101101001011010000000110001010111101010010100000111101011011000101111011011
1110011110101110100101010011101111110011001100000010110000001000011101101001110011110100000011001111111010000100010001100011000101110100001001000010001001010001
1011010100100010110001000110001101100111101001111110111101111101001001001100100110000111011001101100001111111111011100101111110101100110101101101111111101000111
1001000110111010011111111100111001001100101011000000001001000111100011011110110011101110011101100101100011000001000110111000010111001100100101000110001001111101
1101110010010011011000000001110011011101101001011011101011010011001010010000011001000100110000110100110110010101110010100010110001011101111101010010100011000001
1000011011010111000011111111011011010100101101001111001111011001111011011011011100010001111111110101100000110100111110001110111101000101000001111010110111111011
1011010001110100011111000001001010010001100101101000011000011100001001001110010111111011000000010000111111100110100011011100100001010001011111100010010000000011
1011010111000101110001110101100010111011101101111011110011110111101101100100110000100001101111011110010100111100101001010101101111111011001000101111111010111001
1001010101101111100100100101110110011000100100011001100110000001001001110101100110111100100101000111000001100001101101000100101001100001101110001000001110011101
1101110100100000001110101100110011001110110111001101001100110111011011010101110010000111110101110001111101001101101101101110001011001111001100111101100111000111
1001100110001111111100101110000111100100010101100100011101100011001010000101011011110000100100011100101101011111001001001011111001011001011001110000110010010011
1011001100101000011001101011110000110001110000110110111001101001101000111101000010011110001111000110100101001100011011011000001101011101001101000110111011011001
1000011101111011000011001000011110111100100110100100100011001111101110100100011110111011111000011100110001100001010010011111100000000001100101111100101001111101
1011111001011011111111101111000010000110101111101110101001111000100011110111111000100010000011001001110111111111110110110000111111111011110100100001101100000101
1010101101010010100001100011011011101110100110001000001111100010101001010000010010101010101111101011100000100001000100000110000001000001010110001111100111010101
1010000000010110001100001010010010101000110010111010111100001110111100011011000110101110100000111000111010101101101111111111111101111100010011111100101101110101
1010111111010011011111111010110110001011111010101111100001111010001101010011111100001000111110001110011111101101101010001101000100000110111010000110001000100101
1010110001010110000000001010010000101010101000100000001111001011011001011010001111111011100011100011010000001001001000100000011111110111100010110011011010001101
1011100101010011111111011011110101101000101111101011111000011000010011001000100010000010001001101001011101111011011011111011001000000100001010111000010011111101
1011001101111001000000001000111111101110100000001001000011011011111111101011110110111110111100001101000001000010010000001011111011111110111110101101110110001001
1010011100101101110111111110000011000100111011111101111110000010010000001001010100100100101111111001011111011110111110111000000000100010000010100101000100100011
1000110110001001100100000011111001010101110011010101000111011011000111111101010101101101100001100011110101010000101000011111110110101000111010001101011101110111
1111100011101100110110110111001101111101100110000100010001110010010010000000010001100100101011001110100100010110101011001000011100101111110011011001001111000001
1010111001001110100011100110011100000001001110111111010101100110111011111110111111001110101011011100001101110110100001101011000101100001000111110011011000011011
1000001101011000111000001100110111111111011000110001111101001110001001000100011000011010101000010001100101010010111100111011110100111111011100000111010010110001
1011100101011101101111100101110001010000001010100100011001011011101101010111001010110010111011111011001101011010000110100001000110000000010001011101010111100111
1000110001001001100010110100000100011110100011101111000011001011000101010001101010000110001000110011111001000010101111101111011111111111111101000100010011001101
1101111111100011001000100101101111000011110110001001011111101001011100011101101011101111101110011001000011111110100110001101000001100000101001110001111001011001
1001011000111111011111101101101001111000011100111011110000001100000111111001001010000010100011001101011111100011110011011001011100111010000011011111001101001011
1101000010100001000001001000101100001110110001110001100111111001110010000011011110111000111011100101010001001001111001000011010110010011111110010101100001101011
1101011110001011011011011011100101011010000111011011001110011011011110111110000010101010001000110001000100011100111101111011000011010111000011000000110101101001
1001011011011001001000010000110101000011111100001010011011000010010000100111111010100011111101111101111111110110011100011001111110010100010110011110100111001101
1011001001011111101111111111110111101110001101101000110000011111010111110000001000111111000101000100100010000111001001001011000011010101110011000110001110011001
1001101101001100001011000011000110001000100111101011100111110000010011011101101110010001010101010110001011110011101101100010011000010100111010010011111100111011
1100100101101001111010011010011100111010110001001010001101000110111010011001100011110100010001010011111000011000100111001010111111110110101011011010010001110001
1110110100100011000000111000110001110010010100011011011100010010100010110011001000000111110101011000011111010010110001111110100000010110100001110011000111000101
1100010001111111101101101111110101100111011111110010001001111010101110000110011101011100011111011111000110011110011100001100110111000100111100111011110010011101
1001011100110101000101100000011100001101010001100111101100111010100010101100110111110001000000000011110010110000110111011001100001111101110110010000011000111001
1011001110000100011100111011001001111001000100001100000110010010111011101001110000000111111111111010011010000110010001000011111011010101100011011101011111101011
1001101011110101000110001001111011000011111111111111110011010110010011001011010110101110001000001000110010110011000101111110100010000001001011000111001000000001
1101101000010111011111101100100010010111000000010100011001110100110110011001000011111100100011101111110110011111110111000010101110111111011001110001101110111111
1001001010110010010001000110001111110001110101000001001101100111100100111011011001100001101010000000000111010000011110011000101010000100011100011101100010001101
1011100010011010110101010110111010000100011111101111100101001110001110010001011101001011111111111111111100010111000100111101101000110110110111010100101011100101
1000111110110010010101010100100011010111010000001000110100011100111011010101010111011110000100001011000001110101101101110100001010010010100011010110111000110001
1010010010100110110101110110101001011100011011111011110111111001110001011101000110010100101101101001011111100101100100100111111111111010101001000110011010110111
1111011000101100100100010010101101000110110011000001010100000011100100001111101100110001100101101100010000101100110110001100001000100010101100010011001110100011
1100011111101111101111011010001101010100011010010100010001111110001111100001001001100111110000100111110110001110010011100101101010101110111111111111100000111001
1001001000001010001000010011011001110110110011011111011111001100101010111101011011001101011111110001000111111010111001110100100010101100010000000101111111101011
1011111011111000111011110111110011000100011001001100010100011001100010100101011011011000010000111100011100000000011100010110111110101001000111110000010001001001
1010001010000011110011000101100110011111001101011001000001110011111010001101001000010011011110000111110001011111010111000100101010001011111101011111000100011011
1010101000111110100110011100001100110001101001001011111111100110011011101001011111110111000100110001100111110001000011111101100011111000001100001001110101010001
1010101111100010001110111001011101100100000011101001000001001100110001101011010000100101110111100100110101100101101001100001110110101110100111100011010111110111
1000100000001000100000100011000001001101011010001100010100011110000100001000000110001100000000001110000100001100001100001101000000000000110000001000010000000000
1111111111111111111111111111111111111111111111111111111111111111111111111111111111111111111111111111111111111111111111111111111111111111111111111111111111111111
