1111111111111111111111111111111111111111111111111111111111111111111111111111111111111111111111111111111111111111111
0001000010100000011000100000001011000110000110000000000010001101010001000001010001010000000001001100101000000001101
1011111000101101001010001010100010010000110011111010111010100100000100010101000100000111101101100110100011111100101
1000110010111001101011111010110110111101111000001110100000110101111111110101011111101110001101110010001000101110101
1110000110010011101010100011100100101101001111100110101111100101010000110111000100111100111001011010111110100010001
1011111111011001001000101111001101101001011000110100111000110101010110010011110110100001110011000010011010101011101
1000001100001101011101101000011101001011000010010001110010000100010111011000010000101111100110011011010010111011001
1010100111100101111001001101110100011011011111011111011011111111110101001011010111101000110100111111000110001001011
1011110010110101000011011000100111001001000101111000001010001000110101101011000100001101100110000100011111101100001
1001011010010100011110010010001101011101010001100011101010100010000100001001011101111100001110101101110000101110111
1100001000110111110000111111111000010101110100001111001010111111111101111011110001000001111100100101100110100010001
1001101101100100000111100000110011110100111101111010011010101010000100001110000111101111000001101100101110101011111
1011000111001101111100001010010111000110001000000010111010100000101111100000111100100101110111001110100010111000011
1001101100011001100001011111010110010010101111111010110010110110100000111111101110110000010001100000111010001101001
1101000101111011001111110100010100111011100110001110100110011100101110000000001000011111011100111111110011100111101
1001011100001010011000100001010001110001110000100100001111000101100011111111101011111000011001100001000110110000001
1011000111101000110011101111011011000100011111110101111011110111111010000001101001000011110011001011010100111111101
1011101100001011100110001010001001111111011000110100100000000100001010111101001101011110100110011110011110010000001
1001100001111000001110101000111100100011010010000110101111101101100010010101101001001100001111000100111011000111111
1100111111001110111000111111110001101010010111111110101000101001111111000101000011101001111101101101101010011100001
1110001101101000100010100010000111001011110100001000101010001101000001011101010110001011100001101001001000110001101
1011100001000010101111101000101100011001000101100011101011111101010111001101111100101000101111001011101011100111001
1000111101111110101000101111111001001101101100111110111000010100010010011001000001111110100000011001001000111100011
1010011001000011101010000010001011111000101110010000001011010101111000110011011111010000111101111101011110000110111
1011001100011001001011111110100010001010001011011011101110010100111111100110001000011011100001100001001011101100001
1001100111111101011001100100101010101111111000001010100100110110010001001111100011010000001111001111100010101001011
1100110010000101001100110101111110100110001111100010110110100011010100011110111110011110111000011011001000101011001
1110011010110001011110000101000000110010100110111010000100101111010111000100001000110100100011111010011111101110011
1011001000111111000111110101011111111000110010001110111101100110010001110001101011110101101110001000110000001000111
1001011111101100010000000100000110001111111010100100101001110000111100111111111010000100100100100011110111111101101
1011000010100001111111111110101100100100010010111101100011000111101110100001010011011101110101111001100001000000101
1001111000111100100001100011100111110101000110000100111010011100100010001100010110001101000100001100111101110110001
1100001110000110111011001001110001010101111100110110010010110001101011111111000111101001011111011110011000010011111
1001100111110110001010011101011100010101000001100011010110011101001000000011111101001011000110001011001111011000001
1011110100000100101010110000010001000101101111111001000111000101011111011010000000011001110011100011100011010011101
1001100101111111100010011111011111110100100100100011111101110100010010011011101101011100011000110110111000011111001
1101001101000000111011001001000001000110110110101010000001010110111010110000111001110001001010100010001111110000011
1101011100011110001111101101111101110110100000101010101111000100100010111110110011100111111110111010111001000111001
1001000111110011100110101001011001100010101110101110100000011101110110000100000110101100100000100010000011010011101
1011101101000110110100001100001011001010111010100010111111110100100011110111110100000001101111110110101110011000101
1010001000010110010001111001100011111010011000110110100001000110101000010000011101111111101011000100101000111110101
1011111011110011011111001011111110001011001101100010110101010000101010111110110001101100001010011101100011101000101
1000000000011001000000011010000000101001100100111010110101011111111110010100100111001001111000111001111111001011101
1011111111111101011011001010111101101100110110001000100111010000000111000101101100011011010011100011010001101001001
1010001100010001001001111010011001000110010011101111101110011011110101101100000101110010010110111010000101101101101
1011101001011101101100000011001011011111111000100100101100111010110100001111110000100111010000110011011101000100101
1001001011000001101111111111111011001100011110110110001001100010100101100100111111101101011101100110011000011110101
1100011001110101001000010000001001100101001100100111011011001110101111110001100011001100001101001100110011111000101
1111001100100111011111000111101101110001100001110100000001011000100000111011001010011001011001011001100110000011101
1001101110101100010001101100100001011111111111010111101100010010111110001010011000111011110011000011001100111111001
1100101000111101110100101110111111000001010000010000111111110110001000100010110011100011000111111111011001101000011
1001101011100001000110100100001101110100011101111110000010010100111010111110100110101110011101000000010011000011111
1011001001101111011100110111101000010101001100001011111011000101100011100010111100001100110001111101110110011110001
1010011100001000010101110100001011000101100110101010100010011101001110001010011001101001100100000100110110111011011
1010110111111110110100000101100011111100110000100010001111110001011010111011010011111011001111110110100100001001001
1000100011010000100111111101110110001110111010110110111010000101001010010000010110000001011100110111101111101100011
1011101110000111101100001001000100100110001111111100110000111101101011011111110111101100010110000100000110100101001
1000101100111110000001101101011101110100111100001001100111101101100001001100000011000111010010111110101100110001101
1110001001110000111111101001111001100101100001101011001100000000110111100111111010010011111000010000111001111111001
1011101011100111110010101011000011001111001111001001011101111111110011110010001010111010001011011101110011000011011
1000100010001100011000101011011110011010011010011101001000100001011001111010101000001110101111001101000110011010001
1011110110111001011101101010001010111000111010110101101101101100001100101000101101111000100001100101010010111010111
1000011100101011010001101000100010001110101010000001000111000111100110101111101001100011111101110001011110001110001
1011001001100001000111001011111111100100100011111111010001011101110000100010001111001010010001011111001000100010111
1001100011001101101110011001010000110101111010011000010100000100111111101110100100011000110111000001100010101000011
1101110110011100111000111111000110100100000011000011111111110110000000100100111101111101100101101111001111111111001
1000010110110110000011101100010100110111111001011110001010010011011110101101110000001111001100000010011011000011101
1011010010000011111110000101111101100010011101000100100011011011010000001000010111111000011111010110110001011010001
1111111011111010100010110001001001001000110101111101111001011010010111111011110100001011010001110000011101011011011
1000001000110000001011111011100011011101100100000001001101010000111100001000000101101001110100011111001001001001111
1011101110011111111000001010101110010100001111111111100101010101110001101011111101101101100101000011100011011100101
1010000011010110001111100010001011000110100000110010001101010111000111001010010001001001001111111000111001000110001
1011111000010000100010111110111000010011111110011000101001000011011101011000110111011101011010011110101011101111011
1001001111110111111000101000100011111011000011011101101011111001010001001111100100010001000011001100100000100110001
1101011010000100001101100011111001000010010110001001101010101101011101100100001110111011111001100101111111110011011
1001000000101101101101001010010011011111110000100011001000101001001000110001111010100010001100110101010000111001001
1101111101100001100100011111010110011000110111111111111110100011101010111111100010101000100110100100010110000011101
1001000111111111001111110100000010110010011110000000000100101110001010001000101000101111101100110110110010111110001
1011010000010001101000000111111110110111001000111111110001100010111010100011101111101011000110100010010110100000101
1011011111011100101110110000011000100001100011110100111111111010001011101001001000101010010100101111000011101111101
1001000101000110101100011111000011101111111110000110100001000010101001111101011010000010111101100101111010001000001
1101110001110100100101110001111010001011000011010000110101011111101111000001001110110110010000110000011110111110111
1000111100010110110100100100000010111000011000011110011100001001001000011111100010011100110111111011110000100100101
1010001110110110010110111111111110110011111111000011011001100011011101010000111011001001110110100010000101110101101
1011011000010011010000100011000000100110110001110110001100110110010001110110001001101011000010001010110111000101101
1001110011111010011101101001011111101110000100110011100110011100111011000111101100101001111010101010011110010100001
1100100110000010111001001100010011000011011110011000110111111001101010011100000110111100101011101011001100110111101
1101101111011110110011011111110110011000010111001101100011000011000010110101010010010110100001111001100111100001101
1000101100010000010110000001010000111111110011101001001110011111011010100101011011000010001100100011110001101100101
1010100101110101010111111100010110110000111000001011011000111001001000110101110011111011111110001010111100111110001
1011110100111111000011000111011100010110001011111001000011110011101111100100011000101000001011111000100110010111111
1000000110001010011000010001001001110111101010101101111111000110101100101111010010001111100010001110001111010000001
1011111111100011111110111101101011000101101000000101000101011110100110000010011111101010111010111011100110000111011
1010001101111001100011100100101111011100101111011101011100000000110100101110111000100000010010100000110011111101001
1000100101001100101000110101101000010110001010010001001001110111110001111000100010111110110110101010011010001001011
1111110001011110101110010001001101110000111000110111101011010110000111100010101110011000100110001011111000100011001
1000011101001010000111010111011001000111100011110110100001010100111100001011101011001110101100101000101111101001101
1101010101100011111100010001000011011110101110010010001100010101100101111011000001100100101001111110001011001111101
1001010001001000001001111011111111010010101000111010100111110100110101000010011111110101101011000110100010011000101
1101010111101111011011100010000010011010001011101011111110000110110101101110110110000111001011010010111000110010001
1101110100000010011010001110111010110010111000001000000010111110000100111000100010101100011010011010001111100111011
1000100101111110110011011000101000100110011101101010111010100011110110011101111010100110111110111011100001001100001
1010101100100000110110011011101111110011001000111111110010001000000011001001011010111100100000101000101011011110111
1010100110101101100100110010000001000111101010100011000111011111111011101011001010001001110111101110101110010100101
1010110011100111001101100111011011010011001110101001011101010100011001001011100011011011000100000010111100110001101
1010011001101110011101101101011110011000011000101100010100010101001111011001101001000010010101011010000101100111001
1011001100100010110001001000000100111111110010100111110101110101100100011100101011111111110111110011110001001100011
1011101110111010010111011011110001110100000110110101000101010100110001000110111010101000010000010111011111011001001
1001000010100011010100010000010111000001010100100100010100000110011111010110110000100011011011010000000001011111101
1101110110110111011101111111110010010111011101101110110111110111010011011100100110110111001110010101011111000000101
1000100100100001001100100000111000110011111000100100111100010101011000001001101100100101100111010101110001111110001
1010111101110101100110001110101111111110001011110110100001000101011111111011001001110100110100010100000100101011101
1010010000010101110011111010100011000010101111000100101111111101010000100010011101010110010111010111111110100011001
1011000101000100011000000000001000011000100000010110000000000001000110001000110000000011000000010000000010001000010
1111111111111111111111111111111111111111111111111111111111111111111111111111111111111111111111111111111111111111111
