11111111111111111111111111111111111111111111111111111111111111111111111111111111111111111111111111111111111111111111111111111111111111111111111111111111111
00000001100001010000110100001000010110000101000000100000001000101000011000010100010000010101000001100001100001100000011000001100000001100001010000000100001
10111101001101000110000001100011000100110001101110111011100011100011010011000001010101000101010100001011001011001101001011111001011111001111000111010101111
11101100011001101111111111111111110001111101100100000010001010001110010111011111000111110101011111111000011000011001011000011011000110011100010101010100011
10000111110011101000001011000011011111000100110111111111101110111100110001001001111110000101001100001111111111110011110011010001110100110101111101010101001
10110001100110001010100010011001000010011110100001000001000100100101111101101100000010111101100101101100011001010110000110010111000001110100111001010111101
10010111001100111011111000111100011010111010110101101100010101110100100000100111011010110001110101101001001100010100111111000010010101000110010011010010101
11010110011101100011001111101111111000110010010100111001111100010110101111110001001110100100110101000011100110110101101011111110111101010011000111011000001
10010100110001101001100000000110001011100111010110001101000001000010000100011101101000101110000111011110110000110101000010000110101000011001110001011111101
10110001110111001100111111010010111001001101010011100111010111111111110111000100100011111000101100010000011110100101101000110010001011010011011101010001001
10011111000101011001100010011000001101011100011010110001011100000000110001110110110110001101111110110110111010101100111111111010101110011010000101010101011
11000100010100010011001011111111011101000101110000111011001101111110011100010010100100100100011000111100001000101110110001100011100111110000111101011100001
11110101111110111110011000010001000000010100100101101001100101000011000111010110110001110111010011100001111011100010000100101001110000011101110001000111101
10000101000110000000111110110101101111110110101100001100110101111011110010000110011111010100000111001011100000110111111110101101011111011001000111110000111
10111100010100111111101010000100111100010110111111100110100100011000111010110011011000010111010101101000001101110000010000101000000001001111011100011110001
10001110110101100100000011111110110001010010001101110010101111001110011010111111001011000001111100001010111111000101010111101011110111100000000111000110101
11100011100101110001011110001000000111011011100100011010100001100111000010100001101111101100101001111110110001011111110010111001010010111111110010010011101
10111010001100111011110000101111111100011001110101001010110111110011011011101100101000111110001011000100010101000000011000001101000110001000111010111001101
10001011011110000010000111101000110001001100010101100010010011011001110000100110101010011000101010010111110101110110111111101101011100100010100000101111001
11011010000110110110110001101010000101100110110100111111011010001100011110101100101011001111101010110100000101100100010000100001010101111110111010100011011
10010011110100011100011100101011111101110011100110110001001010111111010100101001101011100011001110110110111100111101000110111111000100010110001011101000001
10110111000111010001001111101000101001011001001100000101100000100000010001101101000010111001100110100000101110000101111110011001101111010011101011001111101
10110100010100010111100110001010101011001111011111111100111110101110110111000101101010001100110010101010100111110001000011010011100110011001001110011000101
10100101111111110100110010111010100000011100011000000110100011100111100001110100111000100110111000111111110000111111101111000110001100111101011000111010101
10001100000100010101111010011010110101010001110011010111101000110011001101100110011111101100011011100001011110100001000001110100101001110001001010100010101
11011111110001010000001111010010011101110111000111110011001110011001011100001111001001000111001010001100000100001100010100110101111011011101100010110110001
10001000111101011011111000010111001001100100011100011010011011001101010111111001101100011101101110111111110101111111010111100100110010001100111111100111111
11100010101001000001000011110101101101001110110001001000110001101001000100011011101101111000100000000000010111000001110001101110010110100101100101001100001
10111110001101111111011110100100100111011100011011101111111101001011011101001000101001010011111111111111110110011100111100100011010010110000110001011111011
10100011100101100000010000101110110000010101110010101000001101011010001101101010001011000111000011000000110000110110000110001110011011100110011011000011001
10001000110111001111110110001000011111110100010110100010100100010010111000101011111011011101011000011110011110000111110010111000110001001111001011111001101
11101011110001011101000010111111011000100101000000111111110101110110011011101010001001010001001111111011000011111100011010001011111101011001100001001101001
11001000011101000101011110110000010010110001111110010001000100110011110011001010101101000101100001010001111001100001011011101001000101110011001100011100011
10011110111001110101010011100111000110011011000011010101110110011001000110011011100101111100111101000100001101001111010010001101010100011011011110110111001
10111010010011000100011001001101111111001111101001110100100111001100011100111001110000110001110001101111100100011100010110111001010101001010010010000011011
10010010110111101110111100011100000011100110101101100110001101101001110001101100011010010101100111000000110111110001110100100011010111101010110111011001001
11000110100101101000010111010111101000110010001001001111111101001011100111000111001111000111001101101101110011010111000101101110010011001010000101011111101
11110010001100101101000100010000111101111010101011011010001001011110001110010001100001111110011000101100011001010101011111001000111010011011110101000110101
10011011111110000111110101111010011001010010111000010000100011010000111000111111111011000100110010000111011100010001011000011010100000110001100001110100101
10111010001100110010000001001011000011000110001111111110111111000111110011111000010010010001110111111110010001111101001011111011111101110100001111100001101
10001000100101111011111111100011111001011111101001000010100001111101011001010011010110111111000100010000110111000001100000001000000111000111111010001100101
11101111110111001000100000111010101011001000001100011000101100001100001101000111010110000110011101010110011100011111111111101111110001010001100010111110101
11000000010001100010110110000010100001101111011110111111101111100001100100010001010010110011001101010111011001110100010101101010011101111100110110011100101
10011111111100111010100100111110001101100011001010000000101000111111110001111111011011111001100101010011110011000001010000001000110001000110000011001001101
10110000000110001110101110100011111000111001100010101110101010000110010111100001001000001100110001011010000111011111010111111011110101010011111011101111101
10100101101111101100100011101000011110101101001010111000100011110100110011001100011111100110011111001010111100010100010100110001000111011001100010000100001
10101111000010100101101010001111000100000101011010100011111111000001111110011101111000101100110001111010001101110101110110000101011110001100101110111101111
10100011011000110101111010111101110111110101110011101110001100011111000110110100110010100001100100110011100101000101010011011101001010100110101010001001001
10101110010010100100011000000101000100010100000111001100100101110011010000110110100110111111001110000110110001011101011010011001100010111100100011011011011
10100110111111101101001111110101011101010111111101011001110000111001011111100010001110010011011011110010111111000001001000110011101000011001111011001001001
10110100011000101101100100100101001101011100011000010011011111101101001000001011111011011010010000111010101001011111100010011111001111110011100001101101101
10100101110010001000110110101101100101000001001110110110000000000001101011011110000010010000111010101000001011010010111111110001101000010110001101000101101
10001100100111111110010010100100110001110111100110000100111111111101101011000000101110111101110010001111101011011000110001100100101011010111011001011100101
10100110101100001100111010110110010111000100110010111110000001000101001001101101111000100001000111111001000010010010000100001110101011010001111011000110101
10111100101001101001100010010011011100011101111010110100101101101101011011000100110011101111101110001011011110111011111111111100101010010100001011101110001
10011001100011001011001110111000010001110101000010000111101101001101001110010110010110000000100100101000000110101010100000101001111010110111101110000011101
11110011111110011110011000110010110111000100011111110001111001011001100011110011000011011110110101100011111100100010101010001011000010100010001000101111001
10000110101010110100111010000111100100011101110000011100110011011011111000011001111001110000100000111111000101110110101011111001110110101110111011100110011
10110100000000100001100011101111001101111001011101110110000110001010101110111100001100110101111110010101010101000010101000000011000100100100100011001100111
10011101101111111011111111000110011001000011001001100011111100101000101010001110100110010111000011010100010101111010101111111110011110111101101110011001101
11001100111101010010000001110010111100011111100011001001000001101110100011011000110011000110011001010101110001100010101000001100110010010001000010110011101
11100110011000010111011100010110100101110000001110011011011111100010111001001111111111101100111101000100111111001110100010100101100111010101011010010110001
10110011000011000100001111010100101100111101100000111010010000110110001011100000100000111001100101111110010001011000111111110001001110000111001011010000101
10011011111111111101100010011101100110011000111101110010111110010011100001111110001110000011001101000111010100010010000001011111011011111110011001111110111
10110000011010101111111010111001110010110010011001000110100000111010111101000011111011111111101001010000010111110111111100000100010000110011001101101010011
10000101001010000000100010000011000110010111110011011100110111100000010001011110100000000001001011011111110001100011010001101101010110011001101100000011001
10111101100010111010001111111111010011010001000111000110010100001111110111000000111011111100011010010001000100111001010100111001000111001100100110111011101
10100100111110100010111000100001011000011101011101110011000101101100000110010110001010000111001010110100010110001101010110110011111101100110110010010001001
10001110001000101111100010001011001111111001011000011001110101100101111100110011101000110001101000111111110111011101010011100110001100110010011011010101011
11100011011011101101001111111001100101001011001101001100010100111101000001111001101111111100111111101000110100011001011001001100101001111000111011010111011
10111001000010100100011100001101110100011011100101100101110110100001110111101101000010000110000000100010011101110011011100011001100011001010010001010010001
10001101111110110101011001100101010111001000110101001101000010001111100100000101111000110110101010001111000001100110000111110011111000011111000111010110111
10100101100100110101110011110100010001101110110111011001011111111100101111010100011111110011101111111011111111001111101110000110001111010111111101011100001
10110100110001100100011110000111011011000100010001010011001000010001100011011111001100011001001101010000000001011000000000111100100001010010001001011001111
11100110010111001101000110101110001001110001111101000111101101010100111010010001101001011100011000010111010111010011011111100001111111011000100011001011011
10001111000100011001110011101011011101100101000101101110000101000111101010110100101011000111110011011110010010010110010010101111100000010010111001100010001
10111101101101110011011001100000010001001111101100100011110101111100001000110110101001110010011011011000111010111110111000100000001111111010001111111111101
10010100000101011001001100101011110111100110100110101001100100000001011101100100101100011011000010001011100010000100100011101111111100001110101000100001101
11000101011101001101011110111000110100110000101110111100101101111111000001001101100001011011101111101010001111110101110111001010100001100111100010001100101
11010001111001100001000010001101100101111010000010001001101000100001111111011100110111110010000110000011011100100101100110011000110111110000111011011110001
10010101000011111011011111100101001101011011111110101111001110101101000010010110010100000110110100111110000001101100110000111010110000011010001110000011101
10111101011110110010000001110111011101000011000100100010011000101001101000110011010101010100110101100011111100100110110101100010011011011111101100110110101
10001111010000000111110100010100010100011110010101110110110011101011001111111001010101111111100111101000000110110010011101110111001001001101001001100100101
11100110011111110000011101010001110101110100110100100010100110001000011000011100010100100011001100001111101111111011001101010101101111100100011111101101101
10001100110000011111000111011111010000000101100101101010101100101011111101000101111110001001011001111100101110000001101000010100100000110111001000100001001
11011001111011011011110001000001000111111100110101001010111101111110001001010101100011111101010011010001100100111111001111000110111110110001100010111101011
10010011110001001000011101011100011100011001100101011010100001100000101011010000001011000001010110000101110001100000011001111110000010011100111010001111001
10110110100101101011000101000111111001010011001101011110101111001011101011011111101000011111010100111101011111001011111100101010111011000110001111100010011
10010110101111101001101101110001100011000110011001001000100011011111001001110000111111010000010001110100000110011001100110001000010001110010100000111000111
11010010001010001111001001000100101111111110111111101011101010000100011011000110000001111011111111100111110011001100110110100011010100111010111010101010001
11011000100010111100011011101111101000000010100000101011001000101101010001011111111100100000100001001110011001100110100100111110010110010010001110101111101
10011111111010010101111011001010001010101110101110001001111111111001111111001010001110110110001100011100111100111110101101110000110011110110111000100100001
10110000011011010001100010011010111010111000100111011101100001100011100000011000100100100011111001000101111110011000100101000110011001000100011011110101111
10011011001110011011001110111010010010000011110100010100101100110111001111110011110001101110000011110000011111010011110001011111011111011101110010010001001
11000011101000110001011010110011010111111111000101000110001110010000011000100110111111100110111110011101001100010111010111001010010000010101000111010111011
11111110001011110101001000100110010001100001011111110011111011011011111010001100000100110010000011000111100101110010010011101010110111110001011100010100011
10110100101001010101101101101111010100001101001100011000100001001110000011111001010001100111111001110010110101011010110110001000010001010101010001010001001
10010001111101000101001001001010011111111001101001011110101101100010111111010011010111001100001100111010000101000010100010111011111100010111011011011111101
11000101000001010111011100011000111010001100100011000110100100111000100001010110011100011111100110001000101101101110101010101010001111010010010011000110001
10011111011111110100010111111011101000100110110111110100110110001111110101010011000101110000001111101011111101000100001110101010101001011010110110011100111
10110000010000000101110000000010100010111100100010010110010010100011010101011001101100010101101100001000011001110110111100100000100011001110100111110001101
10110111111011011100011011101110001110000101111000110011011010111001000100001100100111011101001001101111110011100100100001111111101001100110110001100101001
10100100001110001111010001111000111010101100001110011010001110011101011111101110110011000101101011101000010111001101101111010001001100110000111101001111101
10101101100110101000010100001010100011100111101011001011100011001100010000000100111001110100111001001011000100011100100100010101011110111111100001011010101
11100001110011100011111110101110101001110001101011011000101011101001111111111101101101000110011101101001111101110001110001010101110110100001101101010000101
11001111011011001010000100100110101100111011001010001110111001101011000010000000001001011111000100101100001100100111011111010100010100101100001001010110001
10011001001001111011010111110100001110001010011010111010001100001010011000110111111011000011010110100111100110110000010100010111000111101110111111010011011
11011100011100010000010110000111111011101010110000100011101111111110111110011100001001111001110110110010110110011111000101110101110011001010000010011010001
10001110110111011111110100111110110000001000100101110110100000010100100011110001101100001100000100111010010011010001110100100101011010011011111000110010111
10111000000001000001000101110010100101111111101111100010111111000001101000000111101001100111110101100000111001000100111110101100011000110000011111100110011
10001101111111111101011100011000001101000011001011001110000011111111101111111110001011110100010100111110011101110110001100101101001111110111010001110011001
10100001000100011001011001001111111001011010011000011000111000001100100000001100111110000101000110010111010001100011100101101001100000000100000101000111101
10111111010001001011001101100100001011110010111010110010001110100110111111101001100011101101010011010100010111001001110101001101111101011101111100011110001
10100010010101101011101000110101101000011000100010100110101100110010001000101101101001001001111110010001110101011100110101011000000111111001000111010010111
11101000111111101010001010010001001101010011110110001111111001111000111010100101001101100011000100111011100101000111100101011011111100000011010010011000011
11001011100011000010111111110111011111010111010010111000110011011110010010110100011000101110010110101001001101110100001100001000110001111110011000111111001
10011010001001111110110100011110010110010001000111100010010110001100110110010111111010111000110100101101011000100101111111101010010111000111001111100001101
10110010101101000010010001011000110000111101110011001011010011100101100011000100001110000010100001101101001010001100000001001111010100010001100001101101101
10011110111001101011000101000011110111110100010110011111011000110001001111011101100111111111111111001001101111111101011101100011110101111100111101001001001
11000100011100101001111111111110010100000111011100110110011101111011011010001101110000000110000001100011101100010001110100101000000100101110001101011011011
11010001001110101100100011000010110110110101010001100100110000010001010010100101011111110010111011111111001001011100100110111111010110100011100111010010001
10011111111000101110001010011000010100110001000101001101100101011111011000111101000000111010011010100000011011000110001100010001011100101000110011010110101
11001000010011100111111010111111000110011011011101100100111101001000001101100001111011100011001000001111110011110011011111010100001001101101111000010011101
10011011000110110011000010000011111111011010001111110110001101101011111000101111000011001010011111111000000110110110001100011111111011101100011111111001001
10110001111100011010011011111000000001001110111000010000100111101001101011100101101110011110110010000011111100000100111001001000001001000111010100001101011
11100111000001010010110000101111111101101000011011011010110000101100101001110101000100110100100110101110000110111111100011111011011101101100000101111101111
10001101011111000110100110000000000100101011110010001011111110000110100011010001011101110101110000101010111100100100001110100010000100111001110100000100101
10111101001001111100110111111011111110100010010111101010000011011100101110011100011001010000111111101000010001110001100110001110110110100011100101110110001
10110101100011000110011100011010000010111011010011001010111010001101100100110111001011000111101000001011000111100100111100111100100010001110110100100011101
10010000001110010011001101001110101010010010011001011110110010100101110001100000011010011110001011111011111100110110001101100001101111111100010111101001001
11010111011000110111101001100000101111011011001101000100010111110101011100101111110010110000100010001001100110000111100100101111000110000111010001001101011
10011110010011110110000011001101100110010011101001010101010001100101000110100011000110100110101010101100110111110001110110100110010011010000011101100101001
11000011110110000100111110011000110011010110001011110111011101001101010110111001011110110011111111100110100100011111000010110011111001011111010000110101101
10011001100011011101100011110010011001010011011000010001001001011001011100001101000010011000110000110100110001000000011010011000001100010001110111100100101
10111100001010011000101000011111011101010110001011011101101011001011001001111101110111001110010110010001111011111111110011011111101110110100010011001111101
10000111111110110010101111000101000100010011011011010001001011111001100011010101010001100111000111010111000001000010000111000000101000010111011000011010001
11110001000110011110100101110101110111111000011110010111011000011100111010010001011100110100011100010100011011011010111101110101101011110101011101110000101
10011101010011000100110001100100010010001101001100110010001111010110001000110111000110010101111001110101010010001011100000110111001010000101000000111011101
10111001011001110101111101001110111010111001100101111010100100010111101011100100010111010100100011000101111110111001001110100010011110110001010111100010001
10000011011011100100101001011010110010100011111100111011110101110000001001101110110101000101101111011100000000001100011000101010110000011111110000101110111
10111111110010001110101011001000100110001110000110010001000100011111011011001000100001111101001000001101111111111101111101101110000101001100011111101000101
10000001000110101100101001101101101111101010110011011101101111000000001110011011111100110111011101111000110000000101001100100111111111101001001100001110101
11111101011100100110001101101100100001000010111001001000001001111110111000110000010110010100010101001110100111110100011001110100011000111011100001111100101
10010000010001110011111000100110111101011010001101101111111100100000010010111111010011000001110001101000101100110110110011000001001010110010111111000110101
10110111110111010110000011110010101001001111011000101000000101101111110111101000010111111111011011100011101110000011100110011111111010010110000110010100101
10100100110100011100111110011010000011101000010010001101110000000100000101000011110010001100001000111010001010111110001100110000100011000100110011110101101
10001110100101010001100011001011101000101011110110101000111111110101111100011110011000100101101010001110111010100011011101110110001111111110011000010101001
10111010101101010111101011011000111110111010010011111110001000011100100110111000111101111101101111100010010010001011000001100011111000000000111101000100011
10100010100001010010001000001110001100110010111010000011011011000110110100100010001100011000100100111011011011111001111111001110001101101011101111111111001
10101000111111011011011111101011100110000110000010111001010011110000100001110110111001001011110001100010001000011101000110011010100000111110000010000011101
10101110100010010011000001101010110011111111111010001101110110011111110111011100100011100000111101101111101011000100010010110010111110000100111010111010001
10101000111010110110011101000010111000000010001111011000010110110000000100000001101110111111101001001011001011101111111000111000011011011101110010001000111
10101011100010100011110001111000101111101110100100001111010100011101111101101111000100010001001011011010011001101100001111100011001001011000010111011111101
10001000001010001000000101000010000000100000110001100001000001000001000000100000010001000100011000000000111100100001100000001001100011000011010000000000000
11111111111111111111111111111111111111111111111111111111111111111111111111111111111111111111111111111111111111111111111111111111111111111111111111111111111
