111111111111111111111111111111111111111111111111111111111111111111111111111111111111111111111111111111111111111111111111
000001000000000000110000010000010001001100000001010000010001010110100010100000001000011000011000011000110110000010000101
101101011111111110011010110101000101011001011100000111011101000000001010001011100010110011010011000010010000111000110001
111001000100000011001010100101111101010011010111111101000101011011111011111001001010010111011011010111011011101111111011
101011110001101001101010101100110000011010010010000001110101001000011000011111011111000101001110010110010000101010001001
101000110100111101001010100110011111001110111000110101010101101111001111000001010101111101100010110100111110000010111101
101110011110011001011011110011001101101100101101100111000100000001100001111100010000000101111011100101110011111010100001
101011000111001011010001011011100100101001101000110010011111011111110100000111110111011100001010001101010110001010101101
100001110001101010010100000001110110001011000010011010110001110000011101101100110101000001100011011101000100101000101001
101100011101111010111111011111010011101001011111110010000100010101001111001001100101111111111110010001110001101011101101
111111000101010010010001000001011001001101011000111011111111000111100110011011001100010000010000111011100100111010001001
110001110100000111000101111101001101011101001010000001010001111110110100111000011101011111000111110010001110110010101101
100100000111111101111100110000011001000101101011111100011011100000010001101011110001000010011100100111011011100110111001
101110111101010101100110011011110011110100101000101101000000001111111111001001000111111000110110001100001011001100001101
100100011000010000001111010000110110010110111010101001101111111100000011101101010000011110100011011001100010011101101001
110101110011011110100001011111100100110010011110101011101000000101111010001001011111000011111001011100101000110000101101
100100010110001000111111000100001110011011010000100011001011011101001010100011110001011000001100000111101011111010100101
110111000100100011100001110001111000111000011011111110011001011001011000111110100101111011011111110000111110001111110101
100001101111101001101100111111000010001111111010000011001101000011011111101100001100110001010000111110001100100010000101
110100111000111101001101100000011111011000001010111001111001111111010011000001011110011101000110010011100001111011010101
100110010010000111011000101111001000000011111000101100001101011000010110011111000111010001111111011001111111001001011111
101111010111110110001010100011101111101010001011100101101001000011000100110001110100010100000001011100000100011101010001
100001010100000100111011110110100001001110100010001111000011110110011101100111000101011111111101001111010101000001010101
111101000101101101101011000100101101011100101110100011111110100011001101001110011111001100001101100001010001111111000101
110101111101111001001000011101111001001001111011101001001010001110011001011010110001100111011000101101011111000001101101
100100010100100011011111110000010011101011010000101101100010101000110011000010100100110001000011111001001100011100111001
101111010110001110000101010111010110101001000110001001001000111111100111011010001110011101101000100011101001000110010011
100001000011111000110000000001010010001101010111111011011111100001001101010011111111000100111010101010001011101111011001
101101111010001111100111111111011011011001010000010011000010001011011000010110010111110110011110101111011110100101001101
101000001010100001001100000110010010001011011111011010011000101010011110110011000011010011000010100001010000110001100101
101011101011110101100111010100110111111001000100010010111111111010110000011010011001011001111011111101011010110100110101
111010101001010100110010011101100000011101011101110110100000010010000101110010111100001100010001100001010010011101100101
100010001100010110111011000100111111000101010001010011101101000111111111010111100110100111011100101111011011000100110001
101110100111000100011001110110000001110001010111010111000111111100000010010000110000111100010110101001011001110110011101
100011110101111111001100000011011100111111010011000010010110000001111000111110010110001001010000001011001100100011000111
101001000101000001100111101110010110001000011001101000110100111111000010100011010011011011011111111001100110101111010011
101101110001111011110001100100110011101111001100101111100101100110011110111001011110001001110000011100110010100110011001
100100010100110000011100111101111001100001101110111000110101101100110010011101000000101100100111000110111000110011111101
110111011110100101110110001001001100111100100110011010011101001001111011000101111111100110001101110110001111111010000001
100010011000001101000011100011101110000110110011000011000001011011000001110001100100110011111000110010100000001000101101
101010110011100111011000111110100010110100111001111111111111001010011111100100110001111010001110011011111110111111100111
111110011000110010001011110000101000010001101011000100000001011011001000111110010100110000100111001000100000100000110011
100011001111111010111001010110101111111111000001010001111100010010011010011011000111100111110001011110101101101011111001
101001100001011110001100000100100011011000010100011011000111110110110011001010010100001101011100001000100111001000111101
101100111100000011100111111101111001010011111111110010010100010010000111100010111101111001000110111010110000011010011001
100110001101110110110000100000001100011001000000110110110001011011101101111000101001101101010010100011111101111111001011
110010100111000100011110101110100111001101011110010100011111001011000101011111101011000101011011101110000101100001101011
111011110100010101110110100011111101100111000111011101110011101010010001000000001010010001001010001100110100101100001001
100001010110110100000100101001100000110010010010001001000110000011111101111111101000111101101000111001110111101101011011
111101010110010111101101111101001010111010111011101011011110111010000100010000101111101101101111110011100100001001110001
100001000011010001001001010001011110000010001011001010000010001110110111000110001000100000100100000110101110101011000101
101111111010011101011011010101000111111111101001011011101110111100010001111111100011101111101101111110100110111110011111
100101101000110100001000010111110000110110001101010001100110100001111100110010001110001000101001100010110010010000110011
110100101111100111011110110001011110000100111101011100110000101111000110011000111000111110101011001000111011000111111001
100110000000110110010010011100000011110110110001000110010111101001011111001010100011101000101010011111101001110010011101
101110111010100100111010110111011001010011100111110011011110001100001111101011101110000011101011010100001100011011000001
100100011010001101111010010010001100011001101101000110001100111001100110101110001000111010001001000001011111010001011101
110110110011011000110011011010111111001100001001011100100110101111110000101000111010001110101101101111000010011101011001
100010010110001110010111000010000011111111111101011001110100100010011011101011100010100010100100111100010110110101001011
101010110110111011000001110111111000110000110000010011100101101011000010001001101110110110111110110001011100110001111001
111010010010010011011111100100001110000101100111111000110100001001110110111100100111100010000010010101010001100111100011
100011011011000110010000101111101011111101001100110011100111111100100010000110111100001111111011000101110111101100001001
101110001011111100110110001000000000000101011001100110001110001110001011010010010001101000011001101111100100100110111011
100111101000100001100011111011111111011101000011001100101100100111111010010111010111001011000011000110001101110110100001
110010001101101111111011010001000011110001011110011101100001111100010010111100010011011001101001011100111101000100111111
111011100100001000110000011101011000000111001100110101110111100001000110000101111010001011111111000101110001011101100001
100011001111111010011111001101001111110010011001100100110011001111111111101100000011111000110001011101000111001000001011
101001100001100011010101100001100000011110110011110110011110011001100001000111111010000011100100001001010011101101011001
101100111111001001000001111100111111000100011010000111000010110011001101010000011010111111001111111011011010100111111101
100110010000011101101101000110011011110001110010101101111010000110011001011010110010000100011001100010010000110010100001
110111000111110111101101110111001000111111000110111000001000111110110011011010100111110001000011001111011111111010001101
100011111100000011001000110101101010001101011100110011101111100000110110010011101110011111111110011000010001100011011001
101110100111111010011110000001101011101001010110100110000010001111100110110111000010110001000000110011010100001110010011
100000110000010010110011111011001010100011010000101110111010111000001100010010011000111011011111111010010111111010110111
111110100111010110111000100010011010110110011010001000001110100011111101110110110010010001010000001110110000110000110111
110010001101000110011101101110110010100110110010111111011000110110100000010010111111000111010111100110111110011011100011
100111111101110011010001001100110110101100100110100011110011100010001111111000100001110100010001110010100011000010111001
101100010000111001010100011001100010100101101111101001100110111010111000001110101100010101111101011010001001111010011011
101001000110001101010111110011111010110101000101001011001100100010001010100011101111011101000001011010101111011011001001
100011111110101101011100000111100010010100010001011001011001101111111011111001101011001001101101001000111100001111101011
110110000010111001010001111101001111010111111101001100010011101010001001011100001001100011101111101110110001100110001001
100100111110110011000101001000011011010000110001100111110111000000101101000111111100111110100011000100100111110010101101
101110000000100111111111101011111010011010100111101100000000011111100001010100110110100010001001010001101100011000111001
100011111101101100000011000010001000111010101100101001111110110001111111110001100110001110111101111111101001011110001101
101110000111001001111001101110100010010011101001101011100011111100000001000100001100100010010100101000101111010010100001
101000110000011100001100101000111111010110001011101000101000000101101101101111111001111011000110000010001000010111111111
101011111111110101100110101110101001010100111001001101101111110100101101000100011011000011110011111111111011000011010001
101001101000000100110011101000100011010001101101011111000110010111100100011101001011011000111010100001000011110110000101
101101000011111110111001101011110111011111101001000110011100110001110111110001100001001101100010001101110110100100111101
101101011110000010011100001000100100010000001101110100110101100101000100000111111111100101001110111100100100101101101101
101001001000110111010111111110101101110101100000010101110000111101011101111110000110110101011010100110001101100001000101
100011100011110011010011000000100100011101001101110100011110100001001000001100110010010111010000110011111001111111010001
101111001010011010010110011111110111010001011001000101000110101111100010100001111011010011010111110110101100001101011111
101010011000111000110100110000110011010111110011011111110000100000110110111111101010011000000100100010100001100001000101
100011111110001111110001100110000110010000010110001010111110111010011111100000101011001011111110001110001111111011110001
111000101011100010000111001111110100110101011111101000000110101111000101001010000011011001100011011000111001101000011011
101110001000111011011100011000010101111111000110101011110100100101110001111111010110001111001001010011101100101101110001
100011101011110010010111010011010100100001010000101010010001110000011101100001110110100110011101010110001110000100100111
111010001000011011010000010111000110101101111011101010111111011011000100001100110100101100110101010000100100110110001101
100010111101010010011011110101101100100100100001001010000000001011110111111110010001101001110101011101110101100011111001
101110100001010110110010000000111001110110001101011011101101100010010110000011010100111011100101000111010100111000011101
100000101011110110100111011110100011100011111001001001001100111110110011110111011101100011001101110010010110001111010101
110111101000100010110010000111101110001000100011101101100110001000011000110001001000101110011100011000110011111100010001
100101001101101000011010110011001000111110111010100100111111101011011110011011101011101000110101010011111000100001000101
110101011000001111111011111110011101100010001000101110001000001001001011001000101001101010000111011000001110001111111101
100100001111111000001000011000111000001010101010100000101011011111100001101101101100101110110100011110101011111100001001
101110111000010011101101010011101011101111101111111111101111011000110100100100100110100100100101010000101010010001100011
101100000011110110100111010111001001100100001100000011000010010010100110110110110100110001110101110101100011010111111111
100110111011000100110100010001101100111101100101111001011000110110110011100000110111111111000100100100111001010010000001
110010011110011101100101111101000110100000110101001101110011100100011010001111100100000110011110110110001100011011101011
111010110000110001001100011001110000101110011101100100110110001111001000101000101101010010111010100011100111110011001011
100010010111111101011001001011100111101100110001001110100010111101101111111010100101011010010010101000110110000110011001
101111110100000001001111100000111110001001100111011100101110010101101000011010110101001111000110111110010000111110111101
100100000101111111100010111110100010111011101100000110100111010100001101000010010001101000010010000011011111100000001001
110001111100000000111000110000001000100000100110111100101100010001111101111111011111100011111110101011010010111101101011
111111001001111110001101100111111111110111110010011001100101111101100001000001000000101110001100111010011000000111101001
100101011011000111100101001110001000011100011011010011111100000100101111011111111110111000100111100010111011110000111101
110001000001010100110101111100101101010001001011000110001111110110101010000010001100010011110110001110001010111110110001
100100010100010001100000000001100001000101100010010000100000000100001000101000100001000110000000101000100010000000000100
111111111111111111111111111111111111111111111111111111111111111111111111111111111111111111111111111111111111111111111111
