1111111111111111111111111111111111111111111111111111111111111111111111111111111111111111111111111111111111111111111111111111111111
0001100000001010100010000000000011000000110001100000000100000000100000011000100001000010000101010000101000001000011010001101000001
1001001101111000001000111111110110011110100100001101011101110110001101001110001101011000110001000110101011100011000010100100010101
1011101100000011111110001100000100110000101110111111110000100111111101100011011001011101110100011110100000111001111000110111110101
1000111001011111000011101001010001111101101010100000010110101100000111111000010011000100011111111010111110001101101111110010000101
1110001111011000011010001011111011000111001010001111000011101110110011101111111011110111001100001010010000101101000110011011011101
1011100010010011111010111001101010010000011011111001111110001000011001000100000010010001101001100011011111100101011100111001011001
1000111011110110110010011101001010111111110000001101001000111011001100011101111111011101001011111001000000110101011001101100010011
1010101000010100100111001001011010000101011101100100011011110011111101110001010101001001011001010011111110011101000011101111111001
1010101111000101101111111011010011110000010000110001110010011000011001000111000000011011011011000110000011000001010110100001101011
1010000001101100101010100011000110000101000110011101000111000011001101011100011111000001001010010010111001111111010100001100101001
1011111111111001100000101010010010111111111111110101010100011011100101001001110011111111101110111000101101001010010001111110001101
1000001000110011111110101111110110001000000100010001011111110000110101101101100110001100001000101111100101100010111111000111100001
1011100010000110100010101100011100101011110101011111010000011101100101101000001100100001111101100101001100110110010101110010111111
1010111111101100001000100001000001111010100101000100010111000111001101001010111001111111100101110000011110100011010000011000000011
1010000110100001111111110111111111010010101101110001010101010110011101011111100011000000110000011110111010001001010111001101011001
1010110010111111000000100101100001010110001101000111110101110010110001010100001010010110011011000100010011101011010011100111011101
1010011000001011111101101100101100010011100101110100000100111010011101010001111110110111110011110111000110001110011010110001010101
1011001111100010000100100110001101111000110100010101111110101011000111011011000010010001100110010110011100101000110010000100010001
1001101001111010110001110011100100111110010111011101000010001010010001001010011011011101001111010100110001101011111011111111011111
1100101101011010111111111001110110010011010110011001011000101011010101100010110001111001011000010101110111001000001011000001110001
1110001000010010100000111100100011000110010000110011001110101001110100111010011100100011000011010100000001111111101010010100100101
1011111010110110001010010110111011010010111011110111100010101100111110000011001110101111111110010111111100110000101000110110001101
1000011010010011011111000010010001111010011110000100111010111110000110111110011000101000001100110001100110100110101101110011111101
1011000010111010010101111011011100101111010000111110101010000011110010110000110011101010100110111100110100101100100100011000011001
1001111011100010110001101011000110000101000111100010001011111000011011100111110111001011110000010110100101111101110111001101110011
1100011110001110011011001001110100110001111110111000111000001101111001101100010001100001011111010010110001000001010001100111000111
1001000100111011001010011101100101111011100010000010011111100100001100101110111101111101000100000110100111011101011100110011010001
1111110101101001100010110100001100101000001010110111010001110110100110000010110001000111010110111100101100010001000110011001011011
1000010100001100111000100111111110001101111010010101000100010010111111011000100111010011010010100001101110110111010011001111010001
1011000111101110001110001101100011101100001110110101111101110110110001011111101110011000011011101111000100100001011001100011011101
1001110001001000100110100001001001100111011100100101000000100100100101110001001011001101010000001000010001111101111100101010010101
1100011111011110110011111100011101001101010101101101011011101101101100000100011000011111111111011010111111010100110001111010110001
1001001000010100111011000111110101100001000100101000001110001001100110101111111010111000011000001111100010000110010111010010111101
1101101011110001101001010010000100111101101101101101011000111011001100111000001110001011010011111000101000101111000110000110001001
1000100010100111001101111000110110100100101000100111110010110011011001110011100111011010010111000010101111100001101100111111101011
1011111110001110011100011010110100101110100011110011000110100110010011000110110011000010110100011110100000101101001001100110001001
1001001010111100110110110010011101101000111111011001011100101100110110011100011001111110110101110000111111111000011011110100111101
1101100000100001100000100111001001100011110100011100000111100101110011010001001100000010100101100101100000010011110010000001100101
1101101111110101001111101111100011001110000101000111111100001100011110010111111111111010111101001101001111011111000111101111110001
1000101000010111011001101010111110011000110101010110001001111111011000110000010000100010011001011001011001000010011100001001010111
1110001011110000011101001000000111001101110101011100101100001001000010100101000110101111000011010011001011111000111001111100010011
1011111001100111110001011101110001100001000001001001100101100011111111101101010010100100011111011111100001101111100011000001111001
1000011101001100000100001001011101111111101011111011110101110110001101000111111010110110110110010000111101000100001011011100001101
1111010000011001111110100011000101010000111001100010010111000100100001111100010010100100100100110101101101011101101110010110100001
1000010111110011000011111111101101000110001111001110110110010101111100110001000110101110101101100100101001010000100010110011111111
1011110010100111101000100010101001011111100010011100000100110001000110000111110011101010100100101110100011000111111010011001100001
1000011000101110001110001000101011011010111010110101111101111111101111110100010110001010001101100010001110011110001011001101001011
1110111110111000111011111110101001001000001000100001001000100000101000000101011100111000100100110111111010110000101011100100011001
1000100010011101101000001010101101101011011111110111100010101111100011111101000001100010110110010001000011111011101010110111111101
1101101011001101000011100010100100101110010000010010001110100000101110000101110101001111100100111101101001100011000010010110001001
1101001011100001101110101010101110100011000110111011011100101101101011010100010111011000110101101001001100111001111110110000100011
1001011000111111101000101110101100101011011110001001110001101100001000011111011110010010011100001011011110011100000010011111111001
1011001110000001001010000100101001101001001011101101000111100111111011000101000011110111001001100010010011000111011011000100011011
1001100111111100011111110101100011001101101000000101101100110110001001110001111001100011101011111111010111110001001001010001001001
1100110100001001001100011101001111011101101111110100001001100011101100011011011100001001101011000000010000011101101101011111111101
1110000101101011011001000101101000000100101100011111111100111001100111011011010111111111001001111101111010110100101001001000000101
1000111111101011010011110100101011111110100001010001010110001100110001001000010000100010011100001001001011100110111011100011010101
1011100000001001010111000110101001011000101101000100000010100110111011101101010111101000111110100011011000001100000010111110011101
1010001111101101110001101100101100010011111001111111111000110010100001000101010000101111111011111110011011011001010110000011001101
1011101001101100011100100110101111110110110011100010001110110110111100011101011110101000110001000111000001000011011100111001101001
1011001101000101000110110010101000000100011110001000100010100010011001110001011000100010010111010001111111111110010001101100100011
1000011100011111110010011000100010111101001100111111111011101011001100111011001010111111010000011100110001000100110111000110101111
1111110001110100000110111111111111100001100101100101000011001011100110010001100010010001000111110110000100010111110101101110101101
1100010111000101111100011000000011001111110000110000011110011000110011010111111111011101111100000011111111010011000100001100100101
1001010110010101000111001010111110011010111110011011000100111110011011110101000100001100010001111010000001111000011111011001110001
1011110011110100010011101010110000110000100011001001110001101011001001000100010001101001000100100010110100111111110001001011011101
1000111000000110111010001010000111111110001111101100111111000011101101101111011111101111101110101110100110011000000100011010001001
1110101111110011110010111011111110000000100110001111100010011001000100101010011000100000101000101011101111001111011110110010100011
1000000010100110000110011001100000111111110011100001101011011100010110101000110010111110111011101000001001100001010000010111111111
1011010110001100110111001100001111110000111001111100001010010111110010101011110110001010110010001101111101111100010111110001000001
1001111100100101100001100111011000011110001101000110111010110100011110101110000010101010000110111001000000001001011100011100010101
1011000101111101111101110001001011000111100001010010010010010001001100100110111111101011111100000011011011100011110001001101111101
1000010001000100100100111101111001110000110111011011010111011111100101110000000011001001100101111111110001111110000101100111100001
1011111111010110101110010100011100111101100011010001110001000010110100010101111110011100110000010001100111000010111111110010001101
1010001100010010100011010111001110000100110110011100110101111010100111011101100000111110000110110101001110011000100011011011011101
1000111001111010101000000001101010110110011100110110011100110000001101001111001111101100101111100101111000111111101001001000011001
1110011011001000101111111101100011110111000101100011000110010110100001100110011000000001111010001100010011110000101100011111110011
1011001011101011111100001000111001100101110001101011110011011111111111110000110011111111000000111111010111000110100111001000010111
1011101000100001100001101101101100101100111111001000011011001100010001011110011001100011110111100011010001011100110001100011010101
1010001110111111001111100100100110001001100010011101111001101001010100000011001111001000000101110110010111000110011101111110010101
1000111000110000011000110110001111111100001000110100001101101011000111111001100100011111111100100010110000011100110001000010110001
1111100010100111111101100111101110001111101110110111100100101001111110001100110101110000000110001010111111110001100111011000111011
1000001110101110000101001100100100100000111100010001101110101100100100100101110100100110110010111010000001100111001101001110100001
1011111000101100110001011001110001111110001001000101001000100110110101110001100110101100011000001011111100001100011001101010101111
1001100010100101100111011100011011000011101011111111011011110000010100011100101110111001011111101011000111111001111100101000100101
1100110111110101101100010001011110010110101110000100001011011111000111000111100010110011010001001000010000100011010101101110110001
1110010101010100111101110101001100110000000111010101111001000011110101110000111010010111110101101101111110001000000001101100011011
1011010001000110100001000111100111100111110011010100001101101000110000011110000011011110100100111001100011111111101111001001001001
1010010111011110101111010010110011001100011001010111011101101110011110110011111111000100001110001111001011000010101000011111101101
1000110011010000100010011000011001101001001100010000010101001011000100010111010001010101111011100010011000011010101011110000111101
1101111001010110111011011111001111001011111110111111110001011011110101000110010101010101000001111010111111110010001010000110000101
1000101011010100010010010101101100011010000111100011000111011000010111110000110101110101111100110010110000110110111000110111011101
1010001110000111010110110000101001110000110001001000010100001101010000111110100100010101000110000110010110010110011111100001001001
1011101100111110010100000110100011011011111101011111111101100101111110000011101111000100010100111111010010110011001000111011011011
1010100101100011010111011111101110000011010001010000001000110101100011111010001001111111010110001010011010011011101010010010010001
1010110001001001010001110000100111011110010111011110100011110101001010101000111100000010010011100011001010111010001011010110110111
1010010111011101011011100110110001000000110001000011111111000101011000001111100101111011111001111001101010100010101010011100100101
1010110100010101110000101110011101111110011101111000000100011101011111100000110001001000001100001100101010101111111011010001101101
1000110101110100111101101010110101100011110000011111110001110000010001111010111011101111101001100110001010100001000010011011001001
1110011101000110100001001010010000101000000110110000111111000111110100011010001001100001101111110011111011111101110111011001011101
1011001001010010111011011011011110101111110100100110001000011100000101110011101101001111001000111001000011000001000101001101011001
1000011011011000110010010001001100001000111111101111101011110001111101000111000101011100011010101101101010011111011101100001001101
1011110010001111100110111101100110101010000100001000100010000111101001011110010001000001110010000001001110110110010001111101100101
1001000111100100001100110000110011101011110001111110111110110100101011010010111111111101000111010101101100100000110100001000110001
1011011110110101111101100110011000111010011111000110000011100101100001011000110001000100011101011111100101101101110111101011111101
1110010010110100100000001111001110010011000011010100111010001100101111001111100100010111010000011000110001111000010000100001010001
1100111000100110101110101001101000110110011001011101101000101110001101100001101111110011111110110010010100001111011111111111000111
1001110010001100000011111100001011100100111100010000101101111000111000111100100100011000000100100111011111100011001000001100011101
1011010111111101111110001101111011001101110111000110000100110011100010001110110101111111110111101101000101111001101011100001110101
1010010010110000001000100111000010011111100001111111010110011010001111101010000100000000010000000001110100101101101010111111000001
1010111010000111111011110001101110110000001011000001111111001000111101001011111110111101111111111111100110001101001000010010011101
1010111011011110000010011100100010011010101010011101000111101111110001011001101100110001100000001100001111011001011111011000111001
1010010001110000111110110110110111010011111000110100010011001011010111011100100001100111001110100101111110000011000011011101101101
1011000100110111110010000010100001011000001111100111111000011000010000001110101111101110011100110100010100111111011110010001100001
1001111110000100011000101010001101011011100110110000001111111110110111111000100011001010110101111111000101100000011000110100111011
1011000111101101001101111011100111010000110010010111111100010100100101010010111010011000110100010001110100111101110011110110010011
1000010001101001100100100000110100010111111011000010000001000001101100010110011010111010000101000100010110000100110111010011011001
1011111100101011110111101010100101111100011010011000101111111100100111010010110010110011111101111110110010110110010001011001001101
1010000110111000110100001111101100100001000011011111100100001101110001011010010110010110001100000100011011100011011101010011101111
1010101100110011100101101000001110110111111110010000101101100100011101010011010111000100100111110101001000101010001001000110100011
1011100101100110001101111011111000100010100110111110100100110111001001010111000001011101110001100101101110111000101011101100111001
1001110100101110101000100010100011101000110010000100110110010001111011010001111111010100111100111101111010011111101000101001101101
1101000110000010111110001110101110111110011011110001110011011100011001000111000010000110001110000100000011000110001110100011001001
1101101111111110000011100000100110000011010010111100010111010111001101110011011010110011101011110101101001110011101000101010011011
1001000011000111111000110111110011010110010110001111010001010001100100011110010010011111001001100101101100111001001011111000110011
1011011001110101001110011100011011010010110100100010010111011100110111010000110111010000011011001101001110101101111010001111111001
1010011101000000011011000001001010011000110001110110110110001110010000000111100011110111010011011111011010100100100010101000101101
1000110000010101000001010101100000110010100100010000010000100000110101010100001000000100011000000000010000001110001000100010000000
1111111111111111111111111111111111111111111111111111111111111111111111111111111111111111111111111111111111111111111111111111111111
