11111111111111111111111111111111111111111111111111111111111111111111111111111111111111111111111111111111111111111111111111111111111111111111111111111111111111111111111111
00000001000010110000001110001000000010110101010000001000000001100001100011000010000010000010000000101000100001000111000000000100110000110100000111110001010010100001000101
10111101101010000110100100101011111000100001000110111011011100001100001000011011011000101000111110000010101100010010011011110110000110000111010011100100000110001100010101
11110101101010111100110111100001100010001101110010000001010111111111111111111001110011101011100011111011101111111010110011010011011111010110011001001101101110111001110001
10000100101110000101110011001111001111111100011011110101010010001011001010101100011000101110001000011111000000001000100110011001000100010100111100011111001000110011000111
10111110100111101101011001011000011010100111001000011111011000100001100000001111001101100000111011000010011011111011101100111101110101110111100111110000011011100110010011
10000010110000001001001101110011111000001101101101001010010011111101001111100001101111001011101111110110111110001111001101100100111101100001110000011110111001001100111001
10111010011111111011011000010110001101011100001001111000111001100101011000111100000110011001001000110010101100100001011000110110000100111100010111010000001101011001111101
10011011000001100010001111000100100111000110111111000011101100110100001110001111111100111100011010011000100101111101011010000111110110001111010010000111101101010011010001
11001001111101001110100011111101110011101100110001011111000110010111111000101000110001100111110011001101110100110001001011111101010011101001011011110110000101010110000101
10011101010100011000110110001000111000000101100101000001010111010000001011100010010101110100000111101000110110011011101001000000011000001101010010010011111101011110111111
10110100000111110010010000101110011011010100001101111101010000010111100010111111011101000110111100001010010011001001101100010111111111111100000110111010001001001000000011
10010101111100000111111101100011010001111111111100001001011111110000111110001001000111010010100101111111000111101100101111110000010101000111111100100010100011101101111001
11010100000110111110001001110110011111000011010111101011001000100110010000101101110000011000101101010001110011000110101000110110110000010010000001101110111111000111001101
10000111110000000010100011000011001000011000000000100011101010001111010101101101011111111111101001000100111110011100001010011100100111111000110111101100011001110001011001
11110010111111111110111111101001101011111101111111111110001010111100010111000001001000101010000011101110000010110110111011001110101110011101111100000101001100011101010011
10011000100001100010010000111101001001000100110000101010111110011001110001111101100010101000111110100011111010100010010011100100100010110100100001111101100110111001010111
10111110101011001011010110011000011101010110000101100000100110110011011100100001110110001011101100001000101010111000110110110101111010100110001111000100110000010011000011
10100000111010011000010011010011111101010111111101101111110011100110000110110100010111111000100001111110101010011111100000100100001000101111111101010110011111110110011001
10001110010010110011011011011110001000010000000100100001111001101111010100011111010100001110111100110110100011000010001111101101101110000010000100011111011000010011111101
10111011000110011110001001001100100010111111111110111100111100000011010111001100010001101010000110010100110110011000111100001001000011111000110110111000010011011000011001
10101001111111000011111101100001111110100001100010010110010111011110010011101001111111100011010011000101100011110011110001111101111011001111100010010011110110001011001011
10001100100011111010000101111111100011101100001011000011000010010100111000101011000000001001111011111101001000100111000111010001100001101010111011010110010100101111101111
11100110101001000010110101000010001000100111111011011111101000110001111110101000011111111100101000000001011110101110011110010100111100100010001010010000110111100011000001
10110010101100011010010001011000111110110010001001000000111111111011011010001111111000010110101011111111110000111000111011000110000110110110100010111110010000111001011101
10111010100111110011011111001111100000111010101101111010010101000010001000111000100011010010001110001000100111110010100010011111110100000100111110000011011110001101110001
10101000110001100111010001100100001101100010100000000011000001010110100010100010101110011011100100101101101100010111110110110101000101010101110011101001000111101000000101
10001110111100110001010101110111111000111010101010111111111101110110111111101010000010110000110001100101001101000001000100000101011101111100011001001101110001101111111101
10111010101110011011010100110110001010011010111111100000001000000100110001101111111110100101100100110001011001011101010001010001000101000111001100011111011100100011000101
10001000100011001110010110010100101111010010010100001111101010101101100111000111000110110111001111111101011011000101110111111101110101010001100110111000000110101010010001
10100011110111100100110011000101100111010111110001111101001111111000001100010010010010010100011000110001001111111100011100010000110111011100110010000010110100111011011111
10111111000100110001111001111100110010000001000111100001011100001011111001011010111011010001110010011011100100001101010001011011100100000110011011111110011101100010000101
10100001010001111101101100001110111011011111011100101101011001101010000011001110100010011011000111001000110001100111000111001111001101010011000000000100111001001111110001
10111100011011000100000111100010101001001100010110000101001101101110111111011000101111001001101101101010011111110110011101100001011001111111111101010001100011011000011101
10000101001110010111010010111010101101100101110000110111101001000100100001110011101001101100100000101111000010010100110001111101000011000110000111111011001110010011000001
11110101100100110011111010010010001100111101000111110010101011011101101100110110001100101111110110100001111000110110110100011001011111010011010000010010011011011111111101
10000101101101111010101011010111100110001001011100011000101001011000001001100100111110001000110011111100011011100100000101110011010100011001011111011110110001000000001001
10111101001001001000100011010010110011011011001001011110101101000011111011001101100011011010011001100111001110001101111111000111010101111101010101000110011101111111101101
10100001011011101110111010010110000111010011111011000000100101111110001110011100101001000011001100110001100010111000011000010100000100100100010001110011000100001000100111
10110111010010000110010000110000111100010110000011011111110000110000100100110110101101010111100110100100110110011111001011110111110110110111110101011011110001100010110001
10011100010110110011010110011111100101110100101010001000111110010111110110100010101101110010101110111110010111000011101010000100010010110000111100001001011111111110011101
11001110110100011110010111000000001101100111101111101010000111010100010110101110001000111010000010001011010001111001111010111101011110100101100001101100000001101011001001
11100000100101000100110011111111111101001100001000111011110101010001010010100110111110101110111111100000011101001011000011110001010000001101001111100111111100100001101011
11111110101111101101111010001000010001011110111010000010010001111011011000110000011000000010001000001010110001011001010110000111000111101000011100001100001110001100001001
11000000100001001101011010100011011011011010010011111110111100110001001111111101001111111010101011111111100101001101010000111101110000111111110101111001100111111101111101
10011111110101011001001010111111000001000011010110000000101110011111011100000101111000011011100000100001101100011001011111101000011101100001100001000011110010000111100001
10110001011101010011100010000101111101111010010110101101100011000010010001110101100011001001111111101100001101010011000010000011001111001100111101111111111010110000101101
10000101010001000110001111110101000101001000110011101001001011111000110111100101001111101100010000101111111001110111101010110110011000011110000101100011100010111110001001
11111101010111110100100000010100010000011110011001111011011000010011100101001111011100100111010110001000110011100110111000100011110011111011110100101001001010001011111011
10100101010010100101101111110111111111110111001100011010011111000110001101011010010101110010000111111011100110001100001111111110000110001011010110001100011011101010100001
10001100011000101111111000010000001000100001100111001000110001010010111101000000110000011011111100000000101100111001100000000110111100100001010011111111110000101000001111
11011111011110100110000011011111011010001100110101101011100101110110100101111111100101001000001101111101101001100011111111110000101110111100011010000110010110101011111011
10000100000100101100110110001000001011111110010000101010110100111100110000000001101101111111100100000101101011110110000100011111100100100110111010110010110111101000011001
10101101111101100101111100100010101001100011011101101000100110011001111011010100100100010001110101111100001001000011110001110000110101110010100010010110000011001101001101
10111001000101110101000111111010111100110111001001001110110111010011011001111110110111010100000111000111111101111000011011000110000100100110001111011100101110011001100101
10010011010101000001010000110011110110010001100011011100010001010110001100001000011100010111010110010000000100001110110001101111110110001111111000001001111010111101110001
11000110010001111101011110100110000011011100111111000101010101010110100001101011001110110001111100111111110111101000100100101000110011101010001011111011110010000100111111
10011100111111100101011010101110101111010001100001110111011101110100111111001111100110010100100001101000010001101011110110001110100110001000111000001000100110110101100001
11110001101100101101000010101100100001010111001100010010001000100101110001101000110000110110101111000011010111001010000010100100101110111011100011011110001111100101001011
11000101000110000101111010111001110101010011011111011011100011101100010100101010111111110100100101110110010011011011111111110101100010011011001111000000111000001101011011
10010111110011101100011010110011010111011001010011011000101001001111011110100010100001000101110000100100111000010001000000110001110111001010011001111111100011111101001001
10111100011001101101110010010111010001001100011001001110111111011001000000101110101101111101011110101111101111110101011110011100110001101010111100000100001010000111101101
10111001001100100000110111000101011101101001011101101010000010011100011111100010100100010000010000101000100000000101000111000110010100101010101110110101101010110010101101
10010011101110101110010101111100011000101011001000101011111000110001010001111110110111000110110111101010001111111111110101110011111110001000101010110101111110011000001001
11000110100010001011110100000001010011101111101101101000001111100111110100010000110001101100010010101011101000011000010000111000001010111101100000100101000011011111111011
11101100111011100011000111111111010110001000001100001010100101001100100111000110011011000111111010001010100011001011010110001010101000100101001111101100011001010010000011
11001101101000101110011100000110010000111010101001111011110101011110101101111111001001111100000010100000111111100001000011111011101011101100011000100111111100000110111001
10011000001110101000110001110010111111100011111011000000110100000110100100101001101100010001111111101111100000110101010110001110001011000111111110110010001111111110101101
11010011101100101011110111011010000000101000110001111101100111110100110110000011101111010111000001111000110110010111110100100010101001110100000000100110101000001100100101
10000110001001101010000100010010110111101110010111000001001110010101110011101111000011010001010100110010010111011100010101111000101101000111011010101100100011100101101101
10111100101011001000111110110110010011000111010000011111101100110100011001000001111001011101010110000111010001000001011101011111111101010000011011100101111110110101000001
11101001111011011111101100010100111001011101011111110100100101100101001101111100001101000001110111011100010101111111001001000010011001011101010010001101000000010001011111
11001011011001001000000101110101101101000001001000000101110101101101100100001101100101111111100101110001110100100011101011101000110011000111111110111001011111011111001101
10011010001101011011110100000101000101111101101101110000110101001000110111100101110101011000001100100111100110101110001010101111100110010011000100011011010101011001100101
10110010100101110010100101111101011101101101101000110110100100011101100001110100010001000011111110001100001100100110111010001000001100111000010101010010010001001011110001
10100110110100100110101101001101000100100001001010010011101110110111001011000111011111010111000100111001111110110000100010100010111101101110110001110110111011100000011101
10001111110110001100100101101001110110001011011111011110001000100000011110011100001000010101010001110011000110110111110111101111110100100011111011000110110010111011110001
10111110000111111001110101100011000111111011010000010000111011101011001100111001101011110101011111100111010100100010000101001001100110110110001111011100000110000011000111
10010100110001100011010100110110010010011110010111110111101001111001111001110011001000100100010000101110011101111010110101011011001110000100101100010111110010111001011101
11010001111100110111000110010010111000110000110000110001001101000011100011000111011101101110110111101000111001011010010101011010011011110101100001110001010110001101000101
11010101000110110110010011011000001101100111100110011101100101110110101111111110000111001100100001001011110011010011010101000010110000110100101111010100010011100111110001
10010101110110000100111001011101111101001110110111000100110101000000100101100011110001011001111101011011000110010110010101111010000110010110111000000101111001110000011011
10110100110011110101111101001111000111011010000001110110010000011111110001001010011101010011010001001001011111000100110100010010111111000010001110111100011100111111001001
10100110011011000100010001100110010000010000101101000011011111010000011101011011000100010111000111101101000011011101100110110110100001111110100100000111000110000101011101
10110111010000011111011011110000111111110111111111011001011000010110110001001011110111110100010100000001101110010111101100100111101101100010110111101101110111110001000001
10010010010111110001001110111111111010110100001100001101001111110110100101101001000010100111010001011111001100110000001001101100001000001010110100000001100100011101111111
11010110110100010101101000000011010000100101100101111001100011000100101111001101101110001110011111111000011001100110111100001110111111111010010110110111001101001001000101
10010100100001000101100010101110000110110101110001001100101000011101100001011100101000111000110000110011111011110010100111101000100100001011110100011100011101100011010001
10110101111111111100111111101100111110010101011111100101111111110101001011010110101011110010100110100110010000100110110011000011110001101000010101111001000100111110011101
10111101000100010110110110001001100011010101001010110100110000010101011011000100101011011011110011101111000110101100111001111110011011101111000111100011110110010000111001
10000101011101000010000100101011001011011101100010000110011101000101001010011101101001001001100111000101111110111001101100001000110001000001111110001010000011011010001111
11110001010001101110111101100011011000010001101000101111010001110101101000110001001101101100101110010001100010000011001001100010000111011101000100111011111001001011100001
10011111000111001000010001111110011111111011001111100100011011100100101011110111011000100110001000110101001011111001100011110111110100010100010101110010001011101000101011
10110000010100011011110111000110110100001011101100110101110000111110111001010010001110101111101011100111011010001101111110100100011101110111110100011010101010001111111001
10000111011101110001000110010010110001011000100110010100110110001010011100011011100100101011001001110100010010100111000000111101000101100001000111010010101010111000011101
10111110001001000111011100111010100101000010110011010110100111100011000111001000110101100000011100011101110110110100010110001001110001001100011110010110101010110011000001
11100011101011011100010101101000110111111110111011010110110000101111110011101110110000111111111101010000010110010001111111101011011111011111111000110100101110100111110101
10001000101010010110110001001110100100000100101001010000011110100011011001111100100111100000011001000111110000111111101000101001000001011001100010011101100100101100011101
11011110101010110100100111011011111101010001101100011011000010111010001100010001110110001101001011011110111111100010001010101101110100001100001111001001001101100111001001
10001100111010100101110110010001110001111111000101001111111011110000101111011011100000111111101110011000100000001010111010001000010101100110111000011011011000110011100011
11101001100010101101010011010100100111100011101101111000010011000110100011011000101101100000100111001010110111111010001011111101011111110110101101110010001011111001111001
11001100001010001001011011000110001100101000000000100011011000011111101001001010111001001110110001100010010010001011011000001001001000010100101000100110111000101100001101
10011001111111011011001001111110100101101110111111101110001110110000101101101110010011011000111100111111011010101000001111101101100011010001101011101100011110101001101101
10111111000100010010011100001100110100101011110100100011100010100110111100100011011010001011101110001001011010101111101000100111111011011101100010000111001100001111101001
10101100010101110111000111100110110110001001100001110110111011101100000111111011001110111011000111101100001011100000001010110011110001000111001110111101100111100011001011
10100001110100010011110000110011100110111101001101010010010001000111110000101001101100100010010000100111101000110111111010111001100101110110011100110001110000111000011001
10101111000111011010000110011000101100010000011001011000110101011100011110001100101001101111111110110000101110010001100010001100101100110011110101100100111010001111111101
10000001011110010010111111111110001001000111111011001010010111000111010111101110101011001000100000011110100111011100110111011110111110011000000101101110010011101000000101
10111101000000110110000001100011101011111110000001011111010001110100000100100000100011011010001011010010110011000110010001010110001011110011101100101011110110001010101101
10000111111111100110111100001000001110100011101100010110011011010001110001111111111110010011111110000110111001110011011011000011100000011001101110001000000100111010111001
11110011000001101100001111111111011100001000111111010100110000011011011101010000110000111010000011110010101100011011001001111010111011001100100100111011111101101110100011
10110110011011000111101000110001110101111110010100010101111011001110000101000110000111100000101000111110100111010001101101100010001111100110110101100010100100100100101111
10000000111110011100001010000111000101000011010001110100110001100100110001010111011100101111111110001000110100010100101111001000101000101100010000101110001110110001100011
10111111100100110101111011110100010001011001011101100110011100111101111111110101000110101000110111101011110001111110101000011101111010100111010110100100111010011011111001
10110001110001100000110010100101111111111011011000001110110110000100100000110101110100100010100100001001000100001000101101110100100010110001111111110110100011001000001101
10100100100111001111100110001100011000110001001111101010010011110110110110100000100101111110101101011101101110101101100101100110101110011101000100010100001001101101011101
10101110001101011000001110111111010010000101101000000011011000110000100100101111101100000010001001010100111011101001110100110110100111000001010001000101111101001101110001
10100111111001001101111100011011010111111111001011111001011010011111101110100110001001101111011011010110001001000011000110100010110011111111011111111101100100011000100111
10110010011101101100010111001010010100001010011110001101001111000000101010101100111011111000001011010011101100011111011110101000011010101100001000000100001111110011101101
10011011000001100111010011101000110101100000110000100111100001101110001000101001100000000011111010000110100111110001010000101111111010000001101101110111100000000111001001
10111010010100110100011010001011110100111110011011110000111011001000111011111011101111111000110011110000110000111101011011111100010011111111001001000010110110111100011101
10100011111110000110110010111010000110000011110010011101101001111011110001000011001010001110100110111110111110001000001010000001000111000010011011011110000011100001110001
10101011000111011100111000101000110011110111000110110100001101000010011100011110011010100111101110000010100011101110100010111111111100011010110010010000111110001111000101
11101010010001001001100011101110011000100001011100000110111101011111000111010010110010110011001010111000101000100100111010110000010110110000100111110110000010111100011101
11001010111101100011001110000111001101101101001111011100010001001001010000011000110110011001011010011111111010110110011010100111000010011111101101000011111010010111000101
10011110100001111110011000110001100111001001100001001101000111101100011111110011100011011100010011000000001011110011001110110001011000110001000000011110001111010010010101
10110100101111000010111010111011001110011011111101100111111110000101001000011010001010010111110111111111101000011001100110011011011111100101011111110110100100011000110111
10000001100101101010001010001110011000110000110100110010001010110111111011001011101110110000100011000001101101011101110011001110010000001101001100000100110001111011110001
10111111110100001111100011100100110011100110000110011000101010110010001011101011001000111110001001011100100101110001000111101000110110111111100101110101111111000001100101
10100001100110100001111110110101111001101111110011001101101000011000101001101001011011100011111100001001110101100111111100001011110010000000110111000100010001111100111101
10101101001100101100001000010100011100111100011001011001001011111101100011001100011000001000001001101011000001001100010001111000011110111010110001101111010100001111100001
10100101011001100110111011000111010110001001001111010011101111000111111110011001001111101111101011001011011111011001000111010011001100110010011100101001000111100000101101
10101101011011111110011011111101000111011011100100010110001100010011000110111111101100111000001111011001011000010011111101000111100110100111110110001011111100111110100101
10101001001110000011010000000001110101001000110001110110111001111001010100100000100101100011111100011111001011111010100001111100110011101100000111101001011001100010110101
10101011100111011000010111111111000101101101111111100100100011001100010101101110110001101011000001001100011010000010001100000101111001100101101101101011000011001010100101
10111001110001011111110001100000011101100000110000110101110110011111110001000100011111001110011011101001110010111010100111110101011101001101101001001000010111011010001101
10011100111101000000011100101111110000111111100110000100010100110000111111110101000011011100110010111011010110100010110010000100000001011000100011011111110000010011111001
11000110100101011111000101101000011110010000110111011111010101111010101000110111111001010101111000001000010111101110111011110110111101010011110111000110000111110110001101
11110010001101001011110000101011001000110110000101001100000100110010001010010100011101010100011101101101110001100110001000010011100001010110010001110100111110110110100101
10011000111001101000011110101011100011100011111101100110111110010111101111000001010000010001000111000100111100110011111111011001001111010000111100010001100010100000111101
11001101100011001111010011101010101001111010010000110011100011000000100001111111011011110111110010010110000110011001000000011101011000011101101001111111101010001111100001
11100100101010011100011011001000101100100010110110011000111001011110110100100000010010111100011110110111011111001101011111010000010011010100001011000110001000100011001111
10001110101011011001000010011011100101101110000111001110001100010010110110110111110110100001000010010011010000011001000001111111110111000111101010010100111111110110011011
10111010101110000011111110110001110111001010111101100011101111000110011110000101100010101111111011011110010111110011101100101000000101110011001000110101100000111100110001
10000000100100111111100000110111000110011000001100101110100110010011000011111100111010101100100010001100110011000111001110001011110100111001101111100100101101100001111101
11101111110101100011001111100100011100111111100001100000110011111111101001000110001010100101101111100001111001011100011011101010000110000011001010001101100100001111011001
11001001010111001001101010101101110001100001110111111010111011000111001101101110100000110000100000101011111101010101110010001011111111110110011010101101001111111010000011
10011011000110011100001000000100010111001100110010100010101000010010011000100010111110011101111110111010110100010000100110111011000000100010110010111001011000000011101011
11010010010100110111111011110110110101011110011010001110001111111011111110111010100011010001010010011110000111111110001110100000011110101010111010100011010011101010001001
10000110110101110000011111000010110000010011001110111100101000100000001000100010001001110111000111000000101101100011011000101111111010111110100010001111000110111010111011
11110110110100011010110001111110000111111001100000110001111010101010101011101111111100110101110101111111100000001011110011101000000010000100110111111001111100010010100001
10100100100101001110000100000111111100000011111011100111100010111011101001100000000110100101000100011010111110111000100110001110111011101101110100001011101001010110110101
10101101110111100100101111110001000110110110001110001100001110001110001100101011111100101100010101000010101010001110101111101100100000100101100001100000001111010100011111
10001001010011110101100001011100010100110110100100101001111011011100111110111010000001101110110001111010000011011000001111000001111111110001001111111111100100010111010001
10111011011001110100101101000111110111100100110001111011000001001001100110001000101111001000011111001011011001001110100110010111010001011011011010000010110101010011000101
11100010001100100111111101110001100001001101111111110001101011101011001100101101101100011011110001101001011101100011110011011100000100001000010000101110000001111001111101
10001110100110101100000100010100111101011001100000100111001001001010011101100111000101111010000100001101010100111000011001110001111111101111110111111000111111101100110001
10111100111110100110110111010110000001001100001111101101011100011011000100110001101100000011011101011001010110001111001100110111010001001100000000010010010000000110100101
10000110000100110000100010010111111111100001011000001000000111110011101101111101000111111110001101001011010111011101100110100100010101011001111111000111110110110010101101
10110011010001111111111000110011010100001111110011111111110100011000101000110001011100010111100111101011010001001001110011101101000101011100110001111100010010011010001101
10111001010111011001011111111010010001111000100111000110100111011110101010011011000101000010110010101001010101101011010111000111111101000110010101100001011010111011111001
10011101110010001101000000001010110111100010110001010010001110010000100011110001111101111000111010101100011100100010010000011100000001110011000100101111000010001110101011
11010100100110100001011111101010000000101110011101011010111010110101101010000101000001001110001010100111110001111000111111111001111101011001110111101001111111100000101001
10000110101100101011001101001011010111101011011001111010110010000101101110111111011111100011100000101110010100001101101000100011000100011100011110001100010000110110101101
11011110101001111001100001011001110100001001001011000010011000111100101000010001001101111010111111100011000110100100001010110111010110110111000100111001010110000100001101
10001000101011010011111011001100110101111101101001101011001110000110111011110101100001000010010001001000010011111111100010010100010010010101110001110011010011011111100101
10111011111010010111010010011110100100100100101101001111100011111110100001000101111100011011000101011111111110001000111111000101111111000101011111000111011001110000110101
10101000001000110101000110110110111110110001101001101000101000011000101111011100000111110001101101010100001000100011100011111101100001110001000010011100001100000110011101
10001010100010010000010010000000000000100100000011000010001101000010100000000101010000000100001001000001100010101000001000000000001100000100011000110001100101010011000000
11111111111111111111111111111111111111111111111111111111111111111111111111111111111111111111111111111111111111111111111111111111111111111111111111111111111111111111111111
