111111111111111111111111111111111111111111111111111111111111111111111111111111111111111111111111111111111111111111111111111111111111111
000001100000110000110001010100000100001100001000100000110011000011000001011000001001100001010001100001101000001011000000001000000000001
101111001010000111100100000111110001011001111010001010000110011010011100010011100011001100000111001100001111011000011101101011111111101
100010011011010011001111110100000111010011000011011111110010110000110111000110110110011111110010011111101000001011110001101000100010001
111011111001011010011000010001111101010110010110001100011011111110110110011100010011001100011000110000001011011001000111001010001011101
100010001101001000111101011111001000010000110011100110111011000010100100110101011001111001011101111111011001110011011101011111111000111
101110100111101111100001110100011011111111111001110110100010011010001101100101001100110011010000010001001101100110010000000100011110001
100000110011000101110100110001001010000001000011000100101110111011101101001101100110010110010101010101100100101110111111110001001100101
111111111001110101000110011011101010110101101110011101100000110010100101100001110011000110111101110100110110000010010000111111100101101
100000001100100100010011001000101011100100111100110000111111100110110100101111000111111100100000100110110011101011010110001000110101001
111101100110001111011001101110101000001110011001111110001100001100100110101001011111000001101011101110011000111111010011100010010101011
100001111111111010001100101100101111111111000011011000111001111110001100101101000110011111001001000011001110011000011010111111010111001
101111000000011000100110101001100001000101111111010011100011000100111101101001110100110101101100011011101011001011001000011001010011101
100010011011001011110010101011111100010001000000000110001111110101100101101100010001100000101111111001101001101011101111000011011000001
110110110011101010111110101000000110111101010110110010111000000100001101000101011111001010111000001100101101100010001001111001001111101
110110110110001000100000111110111100100101011100111010001010101111011001010001011001011010000010100111101000101111101011010011100000101
100100100100111011101010010100011001101101110001100011101111101001001011111111001100010010111010110011001010001000101001000110111110101
101101101101101001101110110001110011100100000111001110100011000011101011000011100111010110011111111001011010111010100011011100010110101
100001001000001100101100100111000110110111111110011000111010011111001000011000110001110011110000011101011111100010110111010111000100101
101111011110100110100101101110011100010000101010110010101010111000011111110010011100011010000110110001001000001110111100010000010101101
100110010110111100110100100010110101000110000010110110100010100011111000111111010111011000111100100111100011111010001101111101110100101
111100110000010001110110111010110001011111101110100100101110001000110010100000010001001101110101110110110110000011100001011001000110101
110001111111110111010011110010011111000000100000101111101011111111100110111011110101100100000101010000010010111110111111010011011110101
100101100001100110011001010111000001111110111111101000101000000010001110000010000100110111111101011111011010100000001000000110010010101
101100101101001100111100000101110101001100101000001010001111011000111011111111111110010000000001000010010010101101111010110100111010111
100111101101011001110111111100011101011001101010111011111000001111110000100001000100111111111111011010110110000100110010011101100010001
110001100100000011100010101001010001010011000010011010000011111010000110001101010110000110011000010010100111101110000110111000001010101
110100110111111011001000101011000111010111111111001011011110001000111111011000010111010011001101011110101101000011111110110011111011101
100110010101011110011010101011111100010100000011101010000100101010001101001111010010011001100001001000100001111000000010011010001110001
101110110001001100111110101001000101110001111000101010110101101011100101100100011000111100110111111011111100010011111011001110100110101
100010011101100101101100001101101100011111101110101011100101001001110001110111110010100110100100011001000111011110001001100100110010111
101110110001110001100001011101001001000000101100001001001101101100111011010000011011110110001101001101010001000100101100110101111010001
101000100111010100111011110001100011101111100001101100011001000110011000010111001111000011011001101101010101110001101110100100110011101
101011101100011110110000100111001110100011001111111111110011011111001111110011100110011001010011001001011100011111100010101110100110001
101000101001000010011111101101011000111010011000010000000111001100011000011000110100111100010110011011001111010000111011100000101110111
101101100011111011010000001001010011101010111011000111111101100111110010111101100101100111110100111011100001000110101001111101100010001
100100111110101000010111111100011000001000100011110000100000110100000110011111001101101101100101110001111101010010001101000101001011101
110110000000101111010001000111001101011111101110011110110101110110111111001110011100001001001100100111000101111111011000010111011000101
100011011110001101011101010001100001000110000111000110011100010000100011100100110111100011011110001101110000110000001111110110011110101
111001000111100101010101011100110111101100111101010011001110111111111010110001100000111011001111111000110110100111011010010010110000101
100011110101001100000100000101111100001001100001011011100010110000000000011111110110001001100110101110000011101100000000111010100111101
101110000100011001111111111101000111011011001101010000111010010110111111110001010111011100110000000110111111000111101111100000101100001
101100110111110011001000001100010001010010011000010110001011000010011000000101000100001110111111110010001100010110000110001011111001101
111001100100011010011011100111111101110110111111111100101001101111000011011100010111111000100000011011101001111100101100111110001101001
100011001101001010110001110100010100100100000100000111101101001001111111000101010010000011101011001000111011000111111001100000101001011
101110011101100010000100100001000110001110101101110011001101100011001001110111111110111110001001111110011000010000011011101111101101111
100111110100111110111111101111101111111100100000011001111001001001100011010000011000010000101100000011001111110111001010100001000100001
110000000110101010110000101010100110000110101111111100010011111101111000011111000011010111111111101001100000100001101010111101010101101
110111101110100010010110001000110000110011101100001101010110000100001110111001111110010110011000111101111110111101001000010101110111101
100010100000101011110011111010111111111000111001100101010110110111100000001011000011010011010010010001001100110001011111000100010000101
111000111111101000111001011010000000001110110011110111010000010000110111100010011001111001000111110101100101100101000011010111011110101
101110001100001110101101000010101011101010010110110011011111111110011100001110111100011101101100000101110100101101011000011110010110001
100011011001111010000101011111111010000011000100011001000001101011000111111000010111001000001110110100000110111111110011111000110011101
101001000011000011110001000100010010110111111111001101110100000001110011000011010001100010111000011111110110011000100110001011111011001
101111111111011000111011010101010110100100001000011000010111111100111010011111110100110111100011111000110011000010101100100010001001011
101000000001001110010001111101011100111101100011001111000110000110101010111010000110011101001001000010011001111110111001101110101100001
101010101111101011000100101001001110100000101001011001111100101110001010110010111111001000011011011111011100011010011011111000100111101
101011100110001011111111100011100100001111101101000011000001101010111010000110000001100011110001010001001110110011001000100011110000101
100001110000111000000010001110110101011000111101111111111111101000100010110111111101111110110111011101100100000111101101101111011110101
110111011111101111011110111000010101111010000101000101000110001010101111100100001001001100100101001101110111110011001001101000010010111
100100001000000011010000110011000100110011010101010000010000111011100101001111011011100001101101100001010000011001101100000011000110001
101110101010101000010111100110010110100111110100011011010101100001110000011000011010101011101001111100011111001111001101111111010011101
100000100010111111010001101111110111101101100101111011111101001011011111111101110010101010101100010111011001100000011001000001111000101
111111101011100011111101001000110000001001001101100010000111011000000001010101000110101000101111010001001100111111110011011100101011101
100100001110001000100001111010011111111101011100101110110000001111111100010001011110001110000000010101100001110011000111001110001010001
110001011000111110101101100011001000000001000110100000011111100110001111000111011000100111111111110101111100011000011101101011101110101
100111111101100010001111001001101011010101110111111111000000110100100001010011001101110011000100000100001111011011110001001000000110111
101100110101001111011000011011001110011101000101000011111110011101111101011001100111011001010101111111100010010010111101011110110010011
100001100001011100001010111110011100111001011100011001000111110001000101111100110001011101010100100000110110110110000001000010111011001
110111001111000001011011100000110001100011001110111100010000000111010100100110010101000001010110101110010000100111111011111011100001101
110100011000010111110001101111110111110111100100000111111111111101110110110111111101011111010010001011011111101101000010001001001100101
100101110011111100000100101100000101100110110101111100001100011000000100110000000101001101110111111001010000101000011011011101100110101
111101000110000001110110100101110100110000010100000110100001000010111101100110110001101001100000011011010101101101111000010100111110101
100001111100111111011111110100100110010110110101110011101111111110000101001100011101001011001111000010010100001101001111000110001100001
101100100001100000010001100110111111011100100100011001000010000011101101111111001111101000011000011010110111111001011011110011100111111
100110101111001101110100101110100001001001101111001101101010101001100101100011100000101110111111001110110100110011010000110110110100001
110011101000011101100110001010001101100011100110011101001110101100001100001000110110100110100001100100100001100110000110010100010001101
110111001111110001001111111000101001101110110011001001011100100110101111111110010010110010101101111101110100001100111111000101111111101
100101011000010101011000100011111011000110011001111011001001111111111000010111011010011000101100100001011111111001101001010001101000101
101100011011010101000010111010000010011100111100011001101011000011000010110000010010111110100110001111001000101011000011111100001010001
101101110011010101110110001110101010110001100111000011001010011001010110100111111110011100110111111011100010001001011110001111111011111
101001000110000100011111100100111110111011110101111110011010111100010111101110000011001001110100000000110111111100010000100000011000001
101011101100111111001100110110001100001000100000110000111010001111110011001010111001101100010101111110110000000001010101111101001011011
100010001101100011101001100100101001100010111010011111110010101000011010011000011100100111110100001000100101111111110111000111101001001
101111011001101000100011001110101011111110011011001000000111101011011010110011000110110001000111111010101111100000110000010010001101101
101000001111001110110111011010101110001011001011101101110101001001001010100111110010011011011100000010100011001010011111111010111111101
101101100100011000100010010010100011100001100010000001000101011101111010110011011011000010010001111110111010011011001000110010100011001
100101110101110011111110110110111000110111111110111111110001001101000010011010001001111010111011100011100010110001100010010110001001011
110100011101100110000000100100011110010000000100100000011111100001011011011000101101010010111000001001101110100100111111000011111101011
100110111001001111101111110001110011010111110101101111000000101101010001001110111101010110010011111100000110101111100101111110001101001
101110100011011101001100010100010110010001100100101001111110000111011011100110010001010111010110000111110100111000101100010000101001101
101010101110000000011001011111000110111101001101101101000011111100010000110011110111000011010110110001011101100010100101000111100011001
101000100011111111111011000011111100100001011000100000010111000001111111111000110011011110010000011101001001001110110001111101111111011
101110111000100100001011111000100001111101000011111111011100011011000100001110011010000010111111110101101011011000100111100001000010001
101100001110101101100010001110001111000111110111000110001001111110010001100111010011111110101000010001001011010011110100001101101000101
100101011010100000111000100011111100010000010010010011101011000010111111110100000110001100100011110111101000010111000001101000001111101
110001001010111011101111111010000001111111011010111000001001011000100110010001111100100001101000010000001111110001111111111110111000111
111111101010001011001010101010111111000101001110011111111100011111110100111111001101111111101110111111101001011100010001000011100010011
100110001011101001011000001010101100010101100010110001000111110001010001100000011001000010111000110000101100001111000100011000001111001
110000111011001101000010101000100001010000111010000100010000100100010100111110111011111000000010010101100110100011111111111111100001101
100111110010011101111111101111111011011111100011111111111110001111010110001100001000011010101111011100110010111010000010001000111111001
110100010110110000100000100011010010011000001011000000000011111101010100100001111111001110100001001001111000100010101000101011100001011
100101000010011010001010001001000110110011111001110101101000000001010111111101000001100011101101101011011111101110101111100011001101001
110111111011001111111011111100010100100110011100011100111111111111010010000111011100111001000100100000010011001100100100111010011101101
100000011011100000001110000111110111101110110001000001100001100000011000110100001101101101011110110111000110011001110110000010111000101
101111001000111111100100110001100100001010000111110111001100001111111101110001100101100101010110010011011100111111000111111110100010001
111011101101110000110101111100110101111000101100011100011111111000011000011111110100101101010011011001110001100010010010000100111111101
110010000000010110010100000110000100001111111001000001110010000011001011001100010110001001011001001101000111101000111110110101100001111
100110111111010111010101111110110111100000000011111111100110101111101111111001010111011011001101100111011100101111110000100100001100001
101100100011000100010111000011100000101011111110011000110110101010100001000011011100001011100000110110010110001000000111101101111101101
100001101001110101110001011000101111111011010000110010100000101000101101101110001001111000110111100100110011101011110100000111000101001
101111101100011100111101001110100100010000010110000110111011101011111001000111101100011011100011001101111000101001000111011100010101011
100110100101000111100001100100101101011101010111111110001111001000110011110011001111001001001110011101000010101101111110001001110111001
110000110111110010001011110101111001000111000101010011100000011010011000111001100011101101111000110001011110001100000011100011010001011
111110010000111010101001010100110011110001111100000110111111111011001110011100111000100100001011111011000011100111111010111110011101001
100111011110100000101111000110000111011101000101111110010000110001100111000110011110001111101000010010011001110100100010001011000001101
101101000110111010111100011111111100001101010001000011000110010111110001110011010011100001101011000110111100100001101010100000010111101
101001010010001111100001010001000101101001011101011000011111010011011011011000011001111011001011111111101110101011001011111111110100001
100011111011100010001111111100010101001011001111011111110100011010001000001111111100000001011010000001101000101110011010000100010001101
110111100001111010111000100001110001101001100100010000000101001000111101100100001101111101010011011100001110101000111110110101011111101
100011001100100010000010110111011111001011110001000111111101111110110100110001100101000111011010010111100100101010100000010001001100101
111010011111101011111110010100001101011011111111011110001100100010010110011100110101110010010000110000110001111010101111111111100101101
110010110010001010000011000110100101001001100011110000100101101011010011000101111100000110111010100101110111000010100001000000110100001
100110110110111000111001111110111100011100101000110111110101001010011001010111000111101100001111111101010100011111111101111011100101111
101100000100100011101100000010100001110110101110100010000100011010110011010110010001100111100110001001000101110000000100010010001100011
100111110101111110000111110110001111000100101010001110111110111000100110010010111100110010110000101011011100010111011111010110111111001
101100010100001100101101000100111010011101100011111010100000001011110011111010001110011000011111101010001110110101000000000010100101101
100001000111100101100001011101100000110000111010100010101111111000111001101011100011001011111000001010111010000001111111111010110001001
101111111101110100101101010001001010011011100010001010111000011010001101001000001111100010000011111000000010111111000010001010011011011
100001000101010111111100010111011111001001101111011010000011001111100100011011111000110110111110101101111110000110011011011011010011011
111100010000010001000111110110010101101100101000001111111111100000110001111110000010011110001000000111000011111100111010000001011010001
101111111111011101010011000010110000001110100011011101010000111101111111000011011111000011101111010001011000100001101011111111010000111
100100000000001101011010011010110111111010111110001000011010100101000110011001011001010111000000011100011110001111100011000100011011101
110001010101100100001000110000100000000010000000100011000010001100010000111100000011010000010101010001010000101000001000010001010000000
111111111111111111111111111111111111111111111111111111111111111111111111111111111111111111111111111111111111111111111111111111111111111
