1111111111111111111111111111111111111111111111111111111
0010011000011000001000110000010001000011010000000011001
1010110011001011100010011011000101011001000111111001011
1000100111101000111110110010010100011100011110001100011
1110001100001010000111100110111111110111110100101001001
1011111101111011110001001100001000110000000101100011101
1000110001001010011100011001100010010111110000111110001
1010000111011011000101111111110111010000011110001100111
1011111100000001101111100000100001011111000011111001101
1011000001010100000110001010111111000001101110001100001
1001101111110111110100111110100001110100101000100111101
1100111100011100010101101100101100011110111011110001111
1110110001011001011101000001101111001000110010111100001
1010010101000011001101011111100101101101100110100111011
1011000111111111100101001000110100000001101100001101011
1001111110000010110101101010010111111111001001100101001
1011100010101000110101001011000110000001011100110001101
1001001000101101100101011001101100111101010001111111101
1100011111111111001101011100101101101101000100110000001
1001000110000100011001000110100000001001111110100111101
1011110100110001110011010011101111111011100100101101001
1000010001111111000111111001111000011000110001101100011
1111011111001100011100001100110011010010000111100111111
1001011000011001000101101110000110010111111110110000001
1011001011001101101100100111111110110010000000011111101
1011100001100111000101110010001010111010110101010001001
1000111111110001010100111010101000101011100101011101011
1010110001011101010001100010111011100000111101000101001
1010011101000001011111001110100001111110001101110101101
1011001001011111000100011000101111000111101001010100101
1011100011001001110101110010100001010010001011000001101
1010111001101100000100010111111100011010111001111111001
1000001011100111101111010111000111110010110011000001011
1111101010110000111000010010010001000110010110011101011
1000001000011110001110111010111100011111000100111001001
1011111101110111100100100010101111110001110101100011101
1000100100100000110001101110100010000111000100111011001
1110101110001010011111100010101000110110011101110010011
1000000011111111001000110110111111100000110001100110111
1111110110000111100010010000110000110111100111001110001
1100110100110010110111010111100101100011001101011000101
1001100101111000110010010001001101001110011001000011101
1011101111111010011011011101011101111100111101111110001
1010100000110011011001111001010000000101110000011000111
1000111110010110001100000011011011110001010111010011101
1010100011010110101111111110001110111111010010010110001
1010001000010011101000100110100100000101010110110011011
1011111111111001001110001100110110110001000010010110001
1010000000011101100000101001100100111011011111010011101
1010111101001000111111111011101101101011010000011010001
1011110001101110000000000011001101001000010101001000101
1001100111100100111111101010011000011111110111111111101
1100101100110111110000111110110011011000110001100011001
1110000110000000000110000000100110000010010100001000010
1111111111111111111111111111111111111111111111111111111
