11111111111111111111111111111111111111111111111111111111111111111111111111111111111111111111111111111111111111111111111111111111111111111111111111111111111111111111111111
00010000100000100000000001100000011000010000101000000110001100010100001100000000110000010110000001000101000110000011011000100010101000000100101000010000001010000101010001
10010110101011101101010100110111001101010110000011110000100101010101100101011010010111000000110101010000010000101000010010001110000011010110000011011011011000110000011101
10110010001000001001011110100101100001010111111110111111110001010100110001001110110001111111100101011111111101111111110111011100111111010011011111010011110010011111001101
10111111111101011011111010001100111111010100000000100001011111010110111111011100011100100000001101000110001001000110000001000101100010011001001100010110000111001011100101
10010000000111001000001011101001100110010101111110111100011000010100010001000111001110101011111101110100100011010100111111110000001110111101101001110110111101101001110001
11011011010011101111101010111101001100110101000000000001010011110001010101110001100010101110000000111101111010010001100000011111100110100100101011100010100000101101010111
11010001111010111000001000011000011001100101111011111111010110011111110100011100110110101100101110100001001010111111101111000010001100101110101000111000001101101000010011
10010100101000011101111011000011110011001100001110000011010110110001000111001110100100100111111010111011100010000101001011111011011001101100101110001101111111001011011001
10111110101111010001000001110110000110011001100010101010010010000100011101100100110101110000010010001000111011110001011000011001110011001001101011100111000100011011111101
10100010100110010111110100100100111100110011111011101000111011101111111000110110010100111111010111101101110000011101011101001100100111100011001000110011010110111010001001
10001010110010110000011101101101100110110110011001111101101001000110000011100011010110000100010100001100011111010001000101111110001100001110011101111000010100100010100011
11111000011000110111001100101001110000100111001100011000001100011100101110001110010011110101110101111001000001110111010100000011111001111000110000011111110110101110111111
10001111110011100001100111100011011110101101100101001101111111110101101000111000110111000101000001001111101100110101110101011001001011001101110111001000010110100010101001
10111101000111001101110001110110001000100100001111100101000010000101001011110010111100011101011111100000100110000001000101001100011011100000010001100011000100110110100011
10000001011100011000010100010100100010110111100010110101011010101101011000011010100001011001010000001110110011111111011101101111010010101111011100111111111101100010001001
11011011010111111011111111010001111110110110001000110101001000100001001111010011101111110011010111111000111000000011001000100011110110000001000110100000000000101011111101
10011010010000110001100010011111101011100000101011100101011111111111100010011010000100000110010011001101101111101001101101111000010111111101101100111111111110111000000101
11001110110110100111001011011000001001001010111001101101010100001100111000110010111101111100111001100100000000111011101000011110110000101100100110000100001000110010111101
11100110100110110010011010001011101101011111110011001001000001100101101111110110011001000110001100110111111110001110001111000010011110100110110011110101100011100110100001
10110010101100011110110011101011000100010000011001011011111111110100000010000011010011010011101101100000100010100100111001111010110010110010011000010001001110001100101111
10111000101101010000100110001001110110110101001111011110001000100101011011011111010111011001001001001111101000110001100011011010111010111011001111011111111011100111100011
10001011100111000101101111011101000100110111100001000100100010101101011011000001010101011101011011011000001111111111001001010010011000001011100100010010110001110001111001
10101000110001111111001001010001011101100110111101010001101111101101010001111101010001001001001010000011111000010001111100010111001111101000001101111000000100111101011101
11101110110101001010011100011011000111001100000101111011001000001001011100000100011101101011100011111011001011000100010110110101100100001011111001001011011110000000010001
10000110100101100000110110110011110011101001010100011010011011111011001111110111110001001000110110001000011011111111010110100100110001111110000011100001011000111111110111
10110100110100111011100000100110011000001101111110110010110010001011101000010011000101011101111100101110110010000010010000101101111111000111011110001101001111100011000101
10110101100110010010001110110111001111111001000010000111100110111010101101111000011101011100110001100011100111011010111101101000100000010100000111111001100001001001011101
10100100101111010111101100110001100000000011011011010011001100100000101000001111110001001001100111111000001110010010011000101010111111010101010010001111111011011100011001
10101110111000010000101001100100111011111001001001011110011001101111101101100001010111011011001100001111111100110111001011100010001100010111011000100110001010000111110011
10100010010010111110111011001110001110001101011100001000111101001001100111001100010001001010011001101100010101111101101000111111100101010010011111110000101000111110000111
10101111011110101000100010011011100110101100001111101011110001011100110001100101011011101010110011000001110001100000101110000000110101111011110001011101101101101100101101
10101000010000101011110111011000110010100101111000111000011100000110111100111101000001001000100111011111000100101011100011101101100100101001100101000100101001000001100001
10111011111011101010000100000010011000110100110010011111000110110010100110001111110101011111110110000100011110001000111000100100110110101100001100010111101101111011111101
10001011000010000000111111111111001111100110010111010101110011111010001110100000011111010010000100101101111011111110101110101110100100100111111111110011001000001001101101
11011000011111011111100001000101101101001111010010000100011000100000100011111111001000011000101101111000100000001010000100100010101101110000110100011000011111101100101001
10011111110001110000101101010001101001011001111010110101111110111111111001100011100010110011101111010010110110100011110101101010000100111010000101001111111000100110001011
11000000010100100110001001111100000011000011100010010001100010000000011111001001110110111010001000000110000100110110000100111110110101100011110111100011000010110011111001
10011101000110001111111011000110111110011001001111011111001011111111010000011100011110001010111010101111111111111100110110000011100001001010000100001001110110011010001101
11010101111111111000001010010011110000111111011001000011011000100011000111111111001011101110000011111111000100000001100011111000111111011010111101111101100011001010100101
10000101100000001101101000111011000110000100010011111001011110001001111100011001101000000011011110000110010110111111101110001110110101010010000001000100101111111010110001
10101101001011100100111111101001011111111101111000011101010111011101010101000011101011111001110000110000110010100101000000111100100001010111111111110110100110000010011101
10111001011010110110000110001100011000000101100011000100010100010101010001010110001110001101100111110111111000101100011111100001101101110010001000100010110011011111010101
10100011110010100111011100100111010011110001001001101111110101110101010111110100111000101100001110000100001111101001111000101011101000111000101110001010111010010001010101
10101110110110001100001001110010010110011111011101000110000101100001000000100101110011100111111011011101100001000011000010001110001110001101100111011010001010111100010001
10100100000100111110101011011000110011000100010111010011011100110111111110101100000110110010000010001100111101011110011111111100111011011001110001010011101010001110111101
10110111011101100011101000011111111000010111010000011001001110100100000100100111111100111010101010100110010001001000110000010001100000001101011101011000100011100100101001
10100100011000101000001111001000011111110001010111111101101010110101110110110000000110001010111110110011011011111011111111000101001101100101000101001110110110110001101011
10101101110010001110111011100010110010011101010010000000100010010001000011111111010011011010001100111001001000110010000001011111111000110101110101100011100010011111001011
10100100111111111000100001111110011000110101111010111110001011011111101001000010011001010010101001101101101110000111010100001000110011100100000100101001001000110001100001
11110110000000011111101100000011010010000100100010100111111111010000111100011000111101000111101011000111001011111101011111111010011111001110110110101101011111111100101111
10000011111111000000101111110110000111110110110110110100001100010110010111111111101101011101100000011110011000000100001000010011000001100011100010111100001100000001100101
10111110000001111010000001100110111100011100100100000101101001110111000011000000100001001000111111110000111010111101100010110111111100111000101010000101111001101101110101
10011000101100001011111111001100001101001110110111111101001011000011111010011011101111101010000110000111101010000100111110000100000110101110111011110100100011001000010001
11000011111001101011000011011101100101100100100010000001011010011110101011110000000100001011010000111100101011101110011011111110110010100110011000010101101110011011111011
11011110001111001001011000010000111101110001101010110101000010110000101000111110110101111110011111100001100010101111001000010000011010110011001011110101001000111000110001
10001000100000011011001110110111110001011111001010100111111110110110001010000011100100000111001100001011001000100101101011010101111010011001101110000111011010100011100111
10111011111111110001100011100110000111000001101010111100000000100011111111111000111111110011100110101110011010110001101011000100110011010011000100110110001011101110001101
10001010100010111100111011001100111101010100101010010001111111101110000111001101110001011010110110111100111110011011001001111110011110010111110001110100101001001100111001
11111010001000010110001001011101100001011110101011010111000001100011010010011000010100001010100010110001100011001010011011010111000100110101011101100101111101011001100011
10000010111111000010111101000100110101011000101111000101111100001010011000110011110110101000111010000111001001111010110001010001101101100100011000111101110001010011110111
10101010001011111010010101110110000100010010100001111100000111111000111101111000110010101110000010111100011100001010111101010100100100110101001110010000100111010111110001
10111111101010100011000100010011111111110111111011000110110000001101110000011110010110100011111110000101110111100010010001000110110110010001100010110111101100010101100101
10000110000000101111101110111000000101100001000011010110111111100100011010110011010100111000000010111101100001111111011101101100110011010111111000100011000111110100001101
10110011111110100000101000101111110100111101101110010000101100110111010010010111010101100011111010010001001100001100011000101001100110011100001111101110010010000101111001
10011000010000111110101010000110010110100100100110111011100101110001110111000101000100110110001011010111011111101001110010111011001111001001011000100010110110111101100011
11001111010111100000101011110000110100001110110000001001110100011100100011110101111110010100101110010001001010001011011110010001101111100011001010101110010100101100101111
11100011010001001010101000011110110001101000100111111101000001000110001110010001000011011101100010111101101000101000000011000100100110111111101010000111010101100101100111
10111110011101011111101111011010011111101011101110000001110111110111111100111101101001000001111000101100101011101111111001111110110010110000101011111100010101110000110011
10000010110001011000000011001000110100001000111000111111100100010001100001101001001101111111011111101001101001001010101100101110111000000110100001000001010100111111111001
10111010111011001010101001101011100001111110010011100101001101011100101011100011111100100000000100001011101101100000000110100100011111010011111111011111111101100000101101
10001010001111101011111111101001001111100011011000110100011001110110001110001110000110101111110001011010000100111111011100110001110101011010000001000110000001001010001101
11101010100100001001100000001011011000001011010010010001111100100011101100111100110010100010011111001010111110001100001001100111000001001110111101110000111111011011100001
10001011110101011100101010101110011010101010010111011011000110001001100001110001111000111011000011101000100111100110111011101101101101100000001000011111101100001000111101
11011001000101001110101110111100110010111110110110001011110000101100111111000101000010101011011010001111110000110011110010000101101101111111111010110100101001111110101001
10001101011101100000100011100001110110001000100011101000111111111110000100011101111110001001001110101000011110111011000111110101001000110000100010000110000011000110101011
10111100010101111111111001110111011100101011101110001110101000001011110001010000100010111101101000101011000010001000011101010001011110000110101111110011111001010010100001
10000111110000101000001100100100001001101000111000111010100011100000111011111110101011100000001011100011111011011111110000011100010011111110100010011000001111011000101111
10110000111110001101100110001110100011001110011011100010001110111110100001100011101011001111011010111110001000011000011110110111111000000010101011001111100000011111100011
11100110001011101000110111111010111110011011001001001011111000100000110111001010001001011001110010000011011111010011000010000000011101101110111011100000111111110001101001
11001111101001001110110101011000011000110001101101111000011010001111110100011000101100000011100110111001010010010111111011111101001000111000011001101110000001100100111101
10011100001101011100100101000011110010100100100001000011010011111100000101111111111111111111001100101100010110110101001011000101111010110011001100111100101100101110011001
10110101111100010001101101010110000110101110111111011001110110000001111100001000010000001000011001100111000100100001101010010001100010000111100110011001100111101011000011
10100100100101110111001001011110111100100011101010001111100100111011000111101101110111101101111101001101011101110100100010110111001111111110110111010011110011001011111111
10101110110000110011011101010000101001101000100000111100001101101001010000101100100110100001000001011000001101000110101110011100011001000000100010010110011000011000000001
10001100011010011001001100010111101011111110101110100001111100001100011110100001101100111111011101010010101001010010100000111001111011011110101010110111001111111011011101
11100111001011001101011001110101101010001100100010001111000111111001011000110111001001100001001001000111111011111110110101100011010011010110101110100001100010100010010101
10110001101111101101001100010100101010100001110111111010010000001111001011110010011011101101011011011100000010100010010111001010000110010000111000111011001000110110110101
10110100100111000001100110110110100000111111100100110010111011100011011000010110110000001111001001111001111110001011011110011111011100111101100011110010011110011100010101
10010110110010011111110011100100101011100011001110010110011000111010001111000100011110101000011100110011000111011010001100110101010001101001001110100110110011001111010101
11000011111010110100011000001101101110001000011011000011001110011011101001111101110000101011110110000111010011011011100101100000010111001011100100101100111011101010010001
11111111000010000101001111111001000100111111110001010111100011010000101100010001010101111010000011111110011000010001110101111011010011100001110110101101100010001000110111
10001000011111110101100100001100011101100011011100010000110110011110100001010101000100100010111010101000111111111101000000011001011001101111000110100101001010111011100101
10100010111000110100110101100111010101111000000110110110000100111010111111110111101101101110011000000011100010000101111111001101001100101100011100110001011000100010001101
10111111100011100110110100110110000100001110110011100010111101100010001000100010001111001011001101111110001000110101000001100001100110101001110101111111110011101011101101
10001011001110001110010110010011101111101100011001111011100001001111100010111011100100011001100100110000111011100100011101111111110110100011000000100001100110101000101001
10101000011000111011010110111001111000100101111100110001101111101000111110010001110001110011110110011101100001111111110100100000010010111111111110001100101100101110101011
10101101010011110011010000101100110010110001010101100100100110001010101011011100110100111010110111010001001111000010000110101011110110101000000010100110101001100100101001
11101001010110000110011111100110010110111111000100111110110010111010000001000110011110010000000100010111011000011000101110101011000010100011101000111111101011110101100011
10001011010111101110110011001111000010000011010110000110111010010011010101110111001011010111111101110011001011111111100010101010011110110110001101100001101011000101111111
11011001110011000010000110011011111111011001010011110100100011000110010111010011101010010101000100111001111001000001001010111000111010100010111111001101001000011101000101
10001100110110011111010010110001000001001100011001100101101110010010110100000110101000110001101110001100011101110101011110011110100010111010001110011101011111011001010001
10100110000000110001111010010100011011100111111011001111001011110110011101111100001011111101100011100101000000000101000111001100101010001011100100110101000001001011011011
10110100111110100100110011000110110001110100001110011000011000011100110001000001111010001000001110110101010111111101110001100110001011101000110001100101110101101000001001
10010101100011101110100110011110110100110001101100110011110011011001110111011011011010100011101100100101111101000101010100110011111110001110011011110100111101111111111101
10110100001001001010001100111010011110011111000101100110000110000011010001110010010011111110101001101111000100010000011110111011000000111011001110000110011000001000010101
10010101111111011011111001100011001011001101110101101111110011111000011011100111010110000110000011001010010110111111110000101001011111100011100100101111001111101011000101
10110111000110010000011100001001101001101001000100101000011001101111011001001100010010110011011010011000110011100001100110101100010100001001110111100001101000101001110101
11100110010000110111000111111111001100000011010110101011011101000100001100011110111000011001011110111101111000110100001110100111110001111100010001111101000010101101000001
10001100111111100011110010000110011101111110010010001001001101011101111111111000001111111101010000101001001110000111111100101110111011101101111100110001011111101001111101
11011001100001111010111011010100110100100100111111111101011001000000100000001101101000110101110111100011100011111110000101100000100000100000110110010111011000001101100001
10001011111011010010100010010001100110110101111000101001000011111111101110101001000010000100110010101110110111000000101101111101101110111101100011010001000011111100111011
10111000100010000110001110111111001100100101010010000011011110000110000100101111011111011110011010001000110110011101101001000001001010000100101001011101111110000110110001
10011110101000111100111000100010011001110100000111011011110000110000111101100010010110001011001010101010010010110111001011110101011011110110001011001100000000110000100101
11000010001111100110100011111000110011010111111101011001000101111111110101111000110100100001100010100011011000010011011001100111010001100111111001100111011110011010111111
11011011111011001100101110001011110110000000000001001111011111100000000101001110100001110100111110110110001111011001011011001100000101001100101101110110000010111011100011
10001000001001011001101000101000100100111111101011101000010011001110110101011000111111111111110010011100101100001101001000011001111101011110001000010011111010001110001001
10111110101100001011000010101010001110100011001000100011111000011010011101001101110001100000010111001101111001100001101101001011001101000110100011111001100011101100111101
11100000101110101010010110101111101000101010011110111111000011111011000101100000010100101111000001100100001111101111101001101011100111010011101001101100101000101001101101
11001111100110101011011111100011001011101000110010000001111010110001101101001011110110000110010101110111100000111000100011101001110011111000111011000110111110101011001001
10011000110000101001110000111010011011001110100111111100110010000100101001011010000011111100111101010000111010001010111111001100011001101110010000010010010100100001101011
10110010011111101100000110110011011110011011110011000110100111011101101011110010101111000110110000011110101111100010110001100111011100100011010101111111010001111111001001
10110111000110000111111110100110001100110001011000010010110110001101001000111110111100010011100101001100100110111110100100110110010110001011011111000111011011000001011101
10100101110010111101011010001110111001110100001110111010010010100101011110000100100001111000001111111001110000001000101110111100110011011110010000010010010011011100001001
10001100111011110000001011111010101011100101100010101011011011110111000111110001101111000011111000010011000101101010100010001001111010010000110111111000111001000111101011
10111101101000100111100010100010100010001111001011100011001000010100010100011011000001111110000010110110011100101010101111011011000000110110010100011111101101010011001011
10000001001110001110110110001110110111101011011001001001101111000101110101001001111100001100101110000100110110111011100100010011101110010011010111010101000001011010011001
11111100011011111100010110100000110001001001001101101101100011111101000101101100000111101001111011111110110010001001110101110110001000111011110000010100011111001110111101
11000111001010000101010000111111100101101101100100001000111010000101011101101110110100101011110001000010100111101100000101000100101110001000111111010001110001111000110001
10010001101010110001111111100000001101000000110111111110100010110001001101001011100001101001100101101010001111000111111100011101100011011110100010010111000100011101100101
10110100101010111100000001101111111001111110010100001100101110011011111001011000111101001101001100001010100010010000001111110100111011001010101000110110011111000001101101
10100111101010100101010100101101100011000111010001100110100110111110000011000010110001011000011111111011101010111110100100010110001001101010101111110010110001011100100111
11101100001000001111011110100001001111010100011111110011110010000100101001111110011111001111110000011001001110100100111101000000101101000010100000011000100100001111110001
10001001111111100011011010111101011010010101000001011000011000110101111011000111001100011000010111001101011100110001100001011111101101110110111111001111111101111000011101
10101011000000111110010010000111010000110101111101001110111111100100001010010001100001011011000011100101010001110111001111110000100100100010110011101000000100100011000001
10111010011110000010110111101100011011100101000100011000010000110111101010111100111101001001111000110101110111000011101001100110110110111010010110001101110101101111111011
10011011000011111000100000100110110010001101010111110011011010010001001110100110001101101100011110011100110011111001000011001100011100010011000110111001010111001000100001
11001001011000001111101110110100100110111001010001000111010011111101011100101111100111101110110111001110011000001011011111011111000111011001110100101011000100011010110111
11101101110010100110001000010110101100100011011101101101000110000001000001100001110001000010010001100011001011101110010110010101110010001100010001100011011101110010100101
10000100100110110010111111110000100111101110000100001001110010111111111111101101011101111011011100111001101000101000110010110000011011100111111111110110000001000110110101
11011110111111111010110000111111110001100011110111111100100110100011000110000100001001001011011001101101001101101011111010011101001001110010000101100100111101011110010101
11000010000001001010100110000010000100101000010000010110001100101000010100110110101011100001001011000100011000100010101011000101101101000110110000101110011001001011010001
10010111111101100010101111110110111110001101010111000011101101101101110101111110101000101111101000010111110011111110000001110111001100010110011110000011001111101001011101
10110000010001001010000000010000100011111111110001101111001001000101000111000100101010101000001011111110000110110000111100110100011001010011011011111001101000101101000101
10011011010111011011011011111111101011000000111111100001011011101101011100010101111110111011111010001000111100100110101110100101111011111110001000001101111010000101110111
11001110010001001110001110000000001000010110011000101101111011001001010001110001000010011010010010101011101110001100101000101100010001000111101101101100000011110000110011
11101000111101100010100110111111101111110011001010111100110001111011010111011101011011010011000110100001100110111101100011100111000111010010101001100111111110011010011001
11111010001001111010110100001000111000011011100010000110000100110010010001000101001000010110010010110100110100000100101110110010010110011010001100101100000111001111111101
11000010111011000011111101111010000011001010111111110011111110010110111101110001101111110010110110011110000111111110101000011010111100111000101110100111101100011000011001
10010110100010011010000000110010111111101000001000111010001011000100000101100111001000111011110011001011010000100010100011001010001001101111111010110000001001001101001101
10110111101111001110111111100111100010001101100010001000101001111111110101001110011010001000011001101001111110001000101111111011101011000001010000111111100011100101101001
10010001001001011000000001001101001010111000111111111101101100000000010001011010110011101111001100000011100011111101101000011010001000010101000111101000101110111101101011
11011011011011000011011111011001011000101011100011000111000110111111111111000010100110100101100111011110001000110000111011010011101111111101101100001010001000001000101001
11011001010010010111110001001011011111101001001000010011110110000100000101011010001110110000110001000100111110011110010010000111000000011000101110111010101011101110101101
10001100011000110001000101101001010011000011011111111000110011110001110001001111111000011011111101101101100011011010110110111110011111110010001000000011111010100100101101
11100111110011110101011101101101011001101110001101011110011000111100011011100100011101110000000100111001001110001000010111100011000110000111111110101110000010110001100001
10110100110110011111010000001000011100001000111001000011011010011001111010110101010000011111010110011011100011101111010001001000011100111100000011100100111110011111111101
10010001100011010000011111111101110111101011101011011001001111001011000010010101000111000011010011001010101000000101010101111111110001100001101000111101101000111000001101
11011100111000010111111001101001010000111010001000011011100011101011011000110111110001101010010111101000111110110101011100001000110111101100111110000101100011101101011001
11000110011111010001001011001011000110000010111011001000110110001010001110100100011111101110110011001010000011100101001111100010000100100110100011110100101011000001110011
10010011000001011101101000011001101111111110000001111101110000111010111000101101000011000100011001101110101001001101100001111110111101110011101000100110101001011011100111
10111001111101001100100010111100100001010010111111000000011111100010001111100101101000010101001100100111101101011100110100100010010000011001101110110000101100001000101101
10101101000101100110111010010110101101000110010101011111011010111111101000110100111111110101100111110000111001000110100111101011011111011101000010011111101111111010100101
10001000011101111100001011000100111001101111010001001000001000000101001010100110011010100100111100011110000011110100001100001011001100010101011111010001000011001011110101
10101011111001000101101111101101100011000101010101101110100011010000011010001111001000001110011001000111111110110110111101111001100101000100000110010100011110011001000101
10101110000011010101001100000100001111010001011100100011111110011011110011111011101011011111010011110000010000000100001001001101110001101111111100110111110100111011011101
10100000111110010111011001111111111101011111000110111000000111111110000110000010001110001101000110011101110111111111111011101101011111111000100001100011000001101001010101
10111111101000110110010011100001000101000001101100001111110000101100101111011010111100100101111111010101000001000100011010000101010000110010101111001010011101001100010001
10000000000010100000111000001100010000010100000001100000010110000001100000010000100001110000000000000100010100010001000010110000000110000110001000011000110000011001000100
11111111111111111111111111111111111111111111111111111111111111111111111111111111111111111111111111111111111111111111111111111111111111111111111111111111111111111111111111
