11111111111111111111111111111111111111111111111111111111111111111111111111111111111111111111111111111111111111111111111111111
00011000000000100001010101000000010000000000100000100011000000101000011000000000110000110000110100010110000000011010100100011
11010011011110111100010001101111010101111110001111101000010110001111000011111110000110011010000101000011011101001000101101001
10010110000100001001000100001001011100000010100100001110111100100011101111000011111111010011111101111001000111100010000101101
11010011110111101011111111111101000101011010110101111010000101111010100001010110000000010110001000011101010010101011111101001
10011001000100101010000110000101110111001010111101000011110111011000101100010010111111110000100011010001011000101110001101011
10110011011110101011011100110000010011011010100001011000010001001110101111111010100000111111101111110101011110111000100001001
10100110010000100011000001111111011001110010101111001111011101101100100001000010001110010001111000000101000010110011111111101
10110110110111111110011111000001001101000110101011100110011001100001110111010111111011000100011101111101011010100110000001001
10011100100000001000110101111011100001011111101000110100110011001111000011011100010001111101000001000111001110101100111101011
11001101111101101011100001000010111111000011001010000101110110011001111110010001011100010101111101010010011000100111100001001
11100101011001101010101100011010101010011001011111101100010010111100000000110111001101000101000111011010110010110110001101011
10110001000011001000111001010000000010111101001000111101011010000001111101110011100111010001010010001000100110010010100111011
10011111101011111110110011111111111010010101101010100001110011111111010001000110110011011111011000111111101110111010110011001
11000000101110000010100111000000100011000100100010101011100111001000010111011100011010010001001111100010001000100000011001101
10010110100000101010101110011110101111111110111110101110001101100011000100011001110010110101100011001010111111101010111111001
10110100111110101010100100110100100010000010000010001000111000001001111101110011100110010100111010011010000100001111100011101
11100101100010101110101101100101111011101000111111101011101011111100000100100110001111011101110011111011011101111000101010001
10001101001011100100100101001101011010001010100000001001100010000111111110101111011001011000010110001001011000110010001000101
10111000011000110101101101101001000000111111101111111100111010110100001000101000001100010010110100101011000010100110111111101
10011011111110000101001000001011011110100000001100010110001010010001011011101011111101000110100110100001111111101110100001001
11001110000111011101011010101010000011101111111001010000101111011111010010001010000111101111101110111101101000001000101101111
11100010110001010001000011111010110111001000010011011111100000000001000111011010110000111000001000100000101011011111101100001
10101011111100010111111110000010011100011011110111010000111111111101111110001000010110100010111011111110101010010000100111101
10101000000111110110000100111111001001111001100100000110000110010100101100101111110010001111101011011000101011010110001100001
10001111110000010100110001101011011011001101001111111111110011000110100101101000110111111011000010010011101001110111111001101
10111000011110110101111101001000001001100101011010101010011001010010110001001010010000010000011110110110001100110100001011001
10010010111000100100001001100010101100110001010010001000111101011110011111011011011101011101110010000100100110010101101010011
11011110001010101101101111111111101110111101011000100010011101000011001000011010000111011001100110111101110011000100101011011
10010000101010100101101100001000111000001001001110111111001001110111101101110011110010001011001110001100011111111110111001001
10110111101010110100100001100010000010100011100010010001100011100000101001000110011011100010011011101001000100000010001101101
10100010001010010111111111110111111111111001111011010111111110101110101101011111001001111011001000001011010001111011011001101
10111011011011010000110000011100000100010011000010010000001100000111101001001011101100110011101011111111111011101001001100111
10100010001001011101100111000001110001011110011110111011100110110000000011101000000110100110001010000110000010101101100110001
10101111101101110100001101111111011111001000110010101000110011111101011001001011110000101100100000110011011110100001110111011
10001000100100000111111100000110000001100011111000101010011001000111011111011010011111111001111111111010010000101111010101001
11111011110110111110000101010000101100111110101011101011001100010001110001010010110000110011100010110000111010101100000101101
11001000010010000010110111011111111101100000100010001001101111111100110100011010100110100111001010000111100010100101110001101
10011011011011111000010001110000000101001110001111011100100100110110010111110000101100001110011011101100001010110101011100101
10110001001001011111011100111011110101011011111011000110110110010011010100011110101101011010110000111001011011110101000110101
10000101011101010001010110001001100001001000001010010010010011000111010101110000100111000010110110001101001011000101010000101
11111111010100010111010011101100111111101110100000110111011011010001000100010111110011111110011111100111101010010101011111101
10000100000111010100011001101110010001001100101111110001001001110101111101010011011110000111001001110110001110111101011000001
11010001110001000101110011000111010100011001111000011101101100011101010001011001010000110001101100010100100100101001110011101
10011111000111101100111000010100010111111100110011000101100101001100000111001100000111111100001001010101110101100011000110001
11001100011100000110100010110101010010000110010111110100101111101001111101100111111100010111111011000101011100110110011100111
11100110110001011110101111110001011011010111010100010110000100001011000000110000100001000100010011111100000110100100110101101
10110011100111110100101100011101001000010011010101000110110101111001111010011110001111110101010110010101101110001101100000001
10011001001100100101111001000111011111111010010111110011111101001101100011000010100011000001110111010000100011101100110111011
10111101011110001100000011110001110000000010110000011001100001011000101111111011111001011011000011010111111000000110011100001
10001000010011011111111110011100110111111110010111001111001111000010001100011001001101110001011110010100001111111111000101111
10101011111000001010000000110110000100001011011110011000011011111111101001001101100100010111010010110110100010001101110101101
10111001011011100000111110100111111111100001000100111011110010000000111101100000110111010110010110000011110110100100010100101
10001101010010111111101000001100000001001101110101101000110110101010001000111110000011011100110010111001010100110001010110001
11011001010110000000101011100111011101011100000000001010010000101111101010000111111001011001111000001100010101100101000011011
10011011010111101110101001110011001101000111111111011111011101101100001011011100001111010011001111111111000101111111111110001
10110010010001101000001101011001101001010100010001110001000111000110111001110001101000010110011000110001111100110001100011011
10110111000100101011111101001100001011011101000100000101110010010010011101000111101011010000110010010100001110010100111000001
10010001110110001010000001100111111011110001111111111100011011011010110001010100001011011110000111000111101011000110010011111
11011100011111111110111111110110001001000111100000001111000010011010011101011111101010010011111111111110100001111111011001101
10010111000001100000100000010100101100011100001111101001111110110011000111000001000010110110000110011000111100000001001100101
11000011111101001111101111000111100111110001111010101101000100100111110011101101111110010010110011000011101111111101100110101
10010110001100011100000100010001001100110100100000101101010001101101011001000100000111011010011000010111000011010001001110101
10110011100111110110111101110100011110011110101101100100011101001000011101010101010010000011001111110101011001000111101100101
10111001110000100100110100011111000111001100100100110111111001011011000101110111111011011111101101010100011100011100001001101
10001100011110001101100101000010010101100101110110010010001101010011110100110100001010010000100100010001110111111001111011101
10100111000111011101001111111010110100110000011100111000100111010110010110011101101010110110110101111111010000000011001010001
10110011110011011001011011001011100101100111000110001111110001010111010011010001101011100100010100101011000110111111101010101
10111001011000010011000001101001001101101101110111011101000100010000010110011011001001001101010110001010010110100010000010101
10011101000010110110010100101101011100001001100100010101011111111111010011001010011101011101110000100010110011101010110110101
10110001110111100100110110000101000111101101001110110001000110000001011001101010110100010100111111111011111000101011100010101
11100111100001001111100011110101110000100001011100100100011100111101001100000010100001000110000100001000011101101011001000101
10001100101111011000111001100100011110111011010110001111110001100101111001111110110111111111110001101111010101001001111111101
10111110000100010010110011001111001000011110010100111001000111001100110011000100011110000100011111000001000100011100010101001
10110010111101110110010110011101101101001100110101100011011100011110010110010101001000110001000110011101110111010101010001011
10011010100001000111011110111000100111100101100101001110010001000011011100110111101101111111110100110100110010000111011011011
11010000101111110101011000110010110001110000110000011000110111101110001101100001000101000000100101100110011011110011011010001
10010111101000000100000010010110011101011111100101001011100100000111100000111101110001011110110001001111010010111001001000111
10110100001011101111111111010011011001000010101111111010001110110010111111100101100111000110011111101010010110101101101101101
10111101111000101010000100011011010011011000001000010010100010111000010001001100110011110011000100100000110100001001101001001
10000101011101100010101101111001010111011111111010110110111011101111011100011110011000011001010110001111100110111011001011011
10101101010111001010100100001101010101010000011010110100101000100010010001001011011101111101110011011100101100100010011010001
10101100000001111010110111100001010101010110110010000101101110101110110111011000010000101000111001001001100110001010111011101
10100111111100001010100000111111010100000100100111111100000100100100100001010011110111100011101101101011110011111110110001101
10110000000111100011101110100001010111111101101100000111110101110101101101110110100000101000000101101000011000100000100100101
10111011111110111110001000101100010110000101001001010011000100110001111100100100001101101111111101001101001110101111101110001
11100010000000100000111110100111110011110101011011111110010110100111000001101111011111000100001001100101101000100110000111111
11001010111101101110000011110010011000010001010000001100111110101100010111100001000110010101101100110001001011110011101100011
10011110100100000111111000011000111111011111010110100101111000100111110010111101011100111101101110111111011010011000101001001
10111000110111111100011101010010010001010000010011110100010011110000111000001001010001100001001000100110010010110010111011101
10101101110010001001110001110111010100010111111110000111010110011110001101111011010111110111011011101100110110000110010000101
10100001011000100011000100100011110111010110010000110011010011000011101001100001110101100110000011000101100100111111000111101
10101111001011110110011111101110000101010011000111111010011011111000000011001111100001001100111110010001001101110001010001001
10101011100000011100110001101000111100011010010001111010110000001101111011011000001111011001100011011111011001100101111101011
10101010001011000101100100001011110001011010110100110010111110100111000001010011111011001011001001000100010011001100001111001
10001010111011101100001111011001011011110011100110011110011011110001010111000110001001101110011101110101110111011111100001101
10111000101110000101111010011101000000100111001111000111001001011101110011111100101101101100110000100100110001010010111100101
10110011101000110111000011001001011110101110011101110001101100001100111010100001101001001001100110101110011101011000001110101
10100110001011100100011001111011000011101011010000011100000001100110011000111101001101011011001100100011001111001011111000101
10110000101000111101111100010011111001001001000110110101111100110011001110010001011001000001111001111111100011101011000011101
10011011111101100001100001010110001101011101111110100111000111111001100111000111010011111111000011110000111010001010010110001
11001110001101001100111111000100101001010100000010001100010100011100110101111101011010000001011011100110001011011000111100101
11100110101001011110100001111101101011010001011011011001010001000110100100010001000011011101010001001111101000010011111001101
10110100100011010000101100000111000010010111110001001011111111010010101101000101111001000111010111011010101111110111010011001
10110001111001011101100111110011011110110000100101101010001000011011101001101100101101110010011110010000100000010001000110011
10011111001011000111110100111001000010011110101111101010101111110000101111000110100100110110110000110110111101111101101110111
11010001101001010001010001101101101011000111101100001000100000011110001000011100101110010010011011100010010100001001000011101
10010100001101110100011100100100111011110001001001111111101011001011111101110001101011011010110010101011000110101011111000101
10110111101000111111001110001110110001011101011011000001101111101010101000110111100011011010000110101111101100101000010010001
10010100100011100001100011100010011100001001010010010101001000001000001010010001001001001011111100000101000101101111011111011
11000101111110001100111001111011000111101011010110111101111011111101011011011101011101101000000111101100010101000011000010001
10010100000111011110001100000001010000111011010110101000011001000001110001000100010000101011010000101001110101111001111000111
10111110110100010111011001010101111110110010010010001111001101101100100111110110111111101010011110101011000100001111101110011
10001100011101110101001101111111000110100110111011101001100001000110101110110011100010001110110110111011111111101000000111001
11100001111001000001100111000000010010101110011010101011111111110100100000100111001010111100100010001000000101100010110011011
10101011100011110111110100011111111010101100110000101000010101000111111110101110011000101001101011101111110000111110110110001
10001110001110110000010101011000010000100101100101101101010001010010000000100100111111100011001000100000011110011010011100111
11111000101000100111000001110010110111110100001101001001010100011010111111110101100000110111011011111110110000110011000001101
10000011111110001101111111100110000110000111111001011101010110111110000100010001101110000101001001010010011010000111111111101
10111001100011101001000110001111101100111110001111010001000111100011110110111111000011011101101101000111000011110100001000101
10001111001000100011010011011000111001100000100000010111101100001000110010010101111111011000101100010001111110010111100010001
10100011011110111110011001110010001101110101111111110001111001111110011011000000001000010010000111110111000011000011001111101
10111000000110000100111100011011011000011101010001010100011011000111000001111011101011110111111101010001101010011000011010001
10001010110010110001100001000001000011000001000100000101000000010001010100000010000010000000000000010100001000111101010000100
11111111111111111111111111111111111111111111111111111111111111111111111111111111111111111111111111111111111111111111111111111
