111111111111111111111111111111111111111111111111111111111111111111111111111111111111111111111111111111111111111111111111111111111111111111111111111111
000100010000010000101000000000010001101100000100011000011000000000011001101010000101000000101000000000100100010000000110000001000000000011000100000001
101111000111000110001101011011000100101001010001001010110010111101001100000010110100011010001011111110110001010110110011011101111011101001101101011101
100011101100011111100111010001111110100011111111100011100111110001100111011000100111110011100010000010011011011100111001001100100010101100001001000111
111000111110110000110010010111000110110110110001111011001110000111110011011111101110000110111111101011011010010001101101100110110110000111111011110001
101110011010111011111010110001010000110100100100101001100010111110011000010100001000111100001100001001000010110111100101110100010011110100000010011011
100011010000100010000010010101110111100101101110001100111110010000111111110001111011110001100110111111111110010001001101000111011000111101111110110001
110110010111101000111110110101100100001100100111100110000011011010000010000111010010100111110110100001100011010101011001010010001110011000110000010101
100010110110101111100010011100110001111110110101110011111001011011110110111100000110001100010010101100001000010101010011011011100011010011100111010101
101010000100101000111011001110011111101000100101011000001101001000011100101110111111011001111010101111111111110101000110001001111000010110101110010111
101111111101100010010001100011000000100010001100001110111001101111000001100000100000011100000000101001000001000101110100111100101101010010000010110011
100001100001111111010111111001111110110110111110100010001011100010010111110111101111110001011110101101011100011101100101100110100101111011111110111001
101100101111000011010001101011000110011100010000111011101010101011110100010100001000110111110000101001000111111001001100110010110101000011000000101101
100110000010010110010100001000010011001111010110100000100010101000100101000101011010000001100101101101110000100011011110010110010001011110011110000101
110011111010110010111110101111011001100101010010111110111110101110110101011111010010111111001101100100011011101110000011000011011111011000110011010101
111010001000011010100000100001001100110101011011100011101010001100100111010000010110110001111000110101001010001011111001101110000000000011111010011101
100000101111110010111011111111101110110101001000001000000010111001101100010101111110100100010010110101100010111000100011000110101111111111000000110001
101111100011010110001010000010000111100101101011111101111011100011000101110111000010101111011111100100101110101010001110010011111000010001011111110101
111000111000010111101010110110111100001100001010000100011000101111010101000110011010101001000101001111101000100010100111110110001101010100011000000101
110010101110110100001000010000000101111101111010110111001010100001110001011100111011101011110100011000111010101111101100011100100001010101110011111101
100111100000100101111111011111101101000001001010100101101110101100011101010001100011001000010001111010011010111000100001000001111111011111000110000001
101101001110101101010100001000111001101111011000101100100100101111000111000101110110011011111111000011001010010010101111111111110101000011101110111111
101100011011100001000101111010110011001001011110100101110101100001110001110111000110110001100001011001100011010110111001100010100001111001001000101001
100111010001111111010000001010100110011101000010110000110100111011011101100011011100110100001100001011111111010010001100101000101100001100011101100011
110010010100000101011111111010001110110101011000111110010110001000011001001010010001100111111101101110001100011011101110001110101111100111110001110111
111010111110110001110000001011111000100001011111100011010011101101110011011110110111111100000111100010100111111010100111100010001000111100010111000001
110010000100111101000110100010011011111101000110001011111000100100100110010100010101010001110011001000110001100010110011001011011010000001010100011101
100111110110100001101111111111010010000100010100111000101110110111101110110001010100010111011001111110111101001110011010011001001011110111010111111001
101100010010110111100000100101010111010110111101110010100010100001001010110111010001000100001101100010100101011100110011111101111010010100010011000011
101001011010100001001010110001000000010011101001011110101000101101011000010001111101111111101101001010001101000101111000010100000000110111111001011001
100011111010111101111110011100011111111001000011001100001011111001001011111100001001000001001000011011111001110100011111000111010110100110001100010011
101011000010100000000011011001110000001101101011100111111110010011101110000110100011011101100011010000000011010001010011110001111111101100101111111001
101000011110111111111001010011000111011000001000110000000100110111000000110011111110010100111110011111111110011111011000011100100000101001100100001101
101111110100011000001101010110011110010010111111100111010001100001110111111000010000110110000011110001100011000011001010110110001110101011110101011001
100101000001001011101001011111010010111011100001001100011111111100010010011111010111100011110111000100001000011001101110000111111010100011000101010011
110100011111101001101011000110010110001110001101111101110001101111011010110001000000001111000110011101111111111101100111010000011010111001110101000111
110101110100001100101010010000110011100100111100011001000100100001011000100101111111111100011100110111000000110100110100011111000010001100100101111101
100101000101111110101011011111111010110001100111010011011110001011001111101100010001100001001101100010011010000110110101110001111011100110101100100001
101101110100001010100010000110000000011111001100010110001011111011100011001001010100101101100101101000110011110110100001000100110000110011101110101111
101001100111101010111110110011011111010010011001010000100000001000111010011011010110001000110101001111100110000100101111010110011111111000100010100011
101101001110001000100110111010010110011000110011111111111111111010100000111110010110111111111101101000110011010101101010010011000001000010101000101001
100100011000111101110000011000110100111101100110000001000010001110001111111100110100011000001001000010011001110100000010111111111101111010101111111101
110111001101110000011111001111110001100001110010111100011000100111011000011001100101010010111011101111001100011111111110000001001100001010101101000101
100001011001011011110001111000010100001011000110010111111111110001001101001100001111010110000010000111111110110000000111011101100111101110100100010001
111101001011000010100100011011010111111010010111000100010000011101100101100111111010010011111111110010001110110111110001110001110000100010110101111111
100001101011011110001101000010011100001110110011110111000110110100101100110100100010111011001100011010100100100100011100010111000110111000100101000011
101111111001000011011111111110111001011000111110000110011100010110100110010110001000001001011001011010110001101101010111010010010010011111101100011001
101000001101111010010110001000101011001010011000101100110001010010101111010011111111111100010011001110011011001001000000011010111011110001001001111101
101110101101000011010010100011100001100011110011111001111011000110101000011001000000000111010111100010111110011101111111111010110001000100011011100001
100110100101101110011000111110110111110110000110010011010011110100111011111011011111010001000101111000110000111001000000010011100111011111111110001101
110000110001001011010010000010000101100010111111000110000110010101110011010001000110010101110100110011100110101101110111010111001110010010000011011111
111111111111011000011111111011010100111010011011011100111111010101000110010111110100110111000110010110001111100001000101010101011000111010101001010001
100000010101001101110000110010010110010011001000011001100000010100011100110001010101111110010011010100111000101011101101000100010011111000101101000101
101110110001100101100110010110110111000111101011110011001111010111110001111100010100001000111110010101110010111000101001111110110111010010101101101101
100110100100110101001111010000100001101101001110000111011101000100000100110110110110101011100011000100000110011110001100100000010101010111101001000101
110010001101100100011000011110111111001000011100111110000001111101110110000010110011100001001010011111101111001011111110001101110100000001101011011101
111011111101110101111111000011100001011011110101100011111100110000010010110110011001111111011011110000111001101000000100111100100111111101001010000101
101000000100100111100010011000001101111001000001110110000110011110111011100011001100010001011000111010001100001101110101100110101110000111011011110101
101111101110101100001010111111111100101101101011000010110011011000011000111111100111000111010010001011101110111001010001001100100010110010010000111101
100000000010101101111010011101000110001000111011010110010110001111001010000000101101110110010111100010100110100011011111100001111010111011011110011001
111111011010100101011011001000010010100010010010010111010000100001111111110101100001000100111101111110110000101110001100001111100000100010000011010011
110001111110110001001011100011110111111011000111010001011110110100100001100100111011011101101001000000011111100100100001111000111111101111010110010111
100100010100011011101001111111000010001111111100011100000011111110110100101101100001010001000011010111010000110101111111100010010011001010010011000001
101101000001011110001100100001111010100010000001000111111010001000110110001000101111010111010110010001000101100100100000111011000110011010111001111101
101111111101001100100110111100110010101011111111110010101110101110100111111011100011010001110011011101110100001110101110000010011100110010011101100001
100010001111100110110010000110000110111011000000011000001000100010001100101010111001011100011010000100100111111000100111111011110001110110110100111101
110110100011001100111011110011010110001000011111001101011011111011101110000000001100000101001010111110101110001101110010001111000101000010000110000101
100010111010011001101001011001110010101111110011101111010010001010000111111111011111101111101000011010111000100100111000101000011111011111110111110101
101110010010111011001100011100011011101011011000100110010111101010111100001000010000111000001011110010010011110101101111101011110010010000010100100101
100100110110110010011110110111001110001000001010110011110101001011110001101011110101100011111010010111000111000100100000001000111000110111000101101101
110001100100011011011000100001101100111101101010011011000100011000000111001010000101001110001011010001111110011110111011011011101101100011111101001001
110111001101001001001110001011001001100000111011001010011101000011111101011010111100011000101001000100001000111000100010001001000101101110001101011011
100101011111111101100111011001100011101010010011100010111001111110000100001010000111111011101101111111101011101101110111011100010100000000100001001111
101101001100010100110101001100111110101110110110110110110011100010110101101111110010101000111001000001101010000000110100000111110111111110111101100111
100001101001000110000101100110010100100110110100011100011001001010010111000000011010100010110011101100001010101010000101010000100100000011100001110011
101111100011101111110000110011000101110010010001001001001100011111010001111111010010001010000110000111111011111111010111111111101110111000111101011001
111000111110000101011110111001110001000111011101101011100110110000010100000001010111011111111100111110001001000010011100000010001000101110001000001101
100010000111101100001010101100011101011101001101101001110011100111111111111101000101010100000110001100101101011011011001111010111101100111101111101001
101111110100000101100000101111010001010001100111001100011001001101011000000101111101010001110011100101101101001001110011001000100001110010001001001011
101100000110110100111111100010011111000100110010011110111100011000010011110100101101010100111001110100100001101100100111101111101101011000111100011001
101001011110100110110000110110110000011111111010110010010111111111000110010110100001011110101100100110110101101110101110000000111101011011110001111011
101111000000101110010110000100010111110000101010011011010011000000010011000110111011001010100110110110011111001010001000111110011001001010100101000001
100001111111111011010011111101110101100110001011001010011001011011011001111100100011100000110010010011000001011011111101100011001011101010001101011011
101101100000010001011000001001000100101111100001101000111100001001111101100001110110111111100111011011111101000000000100111001100011001011011001011001
101100001011000101001111011011011110100000110111101011111111101100010100101111000100010010001100010000000101111111110110001100111001100001111111001101
100101011001101101100010001001010000111110011100001000011010000111000110100001110001011000111101110110111100010000100100100110011100111100000001101001
111111111100100111111010101011011110101011001101111111000010110011110100101011100111011101110001011100100001010110101101110000110110000111011101001111
110000110111110100000010101000010000100001100001011001111010011000100111111001001100001001100101001001101111010100100111011110010111110011110001100001
100110000100010101111110111111110110110101110101001011011011011111101100001101011111100011001111100011101000010101110001010111010100011001100100110101
101111010001010100100000100011000100110100011101100010010010010000001001100001000000101011011011001010001011110100111100010101000110111101001110011101
100001111111000110101111101001101110100111001111001000110111110111111011111111110110111110010000011110101001010110001111010001110100011001011011000001
101111000110011100101100001100101000101101100110011011100011000100001000110000010010010100110101110100111100010011011000011011100101010011010001110101
100000010010110001100001111110001101101000110010111001001110011101101110000111011011000001110100010001110001111011000011111001001101110111110100111101
101101111010100111001111101011011000101011111010101100011000111001000010111101001001011111000110110111000111000001111110101011011000110001000110000101
100111000011101100011010000001011010001001100010000111111101100011111010100001101111000011110010010010011110011111000000100001011010011011011111010111
110011101111001001111000111101001011111100001111110010111001001110001010110100100011110110100110111011000010111001011011101011001011001000010001110001
111001100001011100001101101001101010001001011100011010010011011000101010110110111001100000110010011001101110101100011110001001101111101111110100111011
101100111011000111100001001011001110101011011001000011000111010011111010010110001100111110011011001100100110101001000100111101101000101001010110010001
100101101001110000111011100001100000101111001111101111101100011000110011010011011110100011011011100110110010101011110001110100101010001100010011011011
110000101100011110011110001100111111100001101000100100001101110010010110011001110000111001001001110010011110101000111111010110100010100110111001001001
111110101001011011001100111111100000111101001010110110100100100111010010111100100111100011101100010111001000101110011000000010001111110110101101101101
111000001011000001011001100001110110000101011010100010110110111110011010101110101110110110100110110101011011100011001011101111111000110000001001101001
110011111001110101001011001100100110110001000010101011110100100011000010101010100010100000110111100001001001101011101010100110000010011111101011001011
100110001100100111101011011110001100011111111110111010000101101010011110000000111010001101100100001101101100101001001000110011011111010001111010011001
101100101110110010001001010111111111001000001010001000110100101011000011101011110010111001001101011000100110111100011111111001010001000101000010111101
101101100010010110111111010100010110011011101011101110111101101001111000111110000110001011011111011011101100000110110000001101011101111101011110110001
100100111011011100100000010101000000110011001001100100001001001101101110011000111111101001001000010010100111010010111010101101000100011001001010010101
111110110010010001101101110001111111100110011100110110101011011001000111010011100001111101101110110110110011111010011011101001110101110011101011011101
100010100110110111101001000111000100001100110110010011101000001011011100010110001100000000100010010000011001100011010011000011100100010111001000000001
101000101100010000111011110011010001011110100111011001001011111001001101110100111111101011111011011111011100101110000110011111001101000100011011111101
101111100101011110011000010110011111111000101100011101111110001101100001100110010100001110000011010001010110001011111110111000011001010001110010001101
101101110111000011010011011100110000100011100001000100010000100100101101001111010101111100111110011011010011111010000010001011011111111011000110100111
100101010000011001011001000001100110110110110111110111011101110110111001011000010101000101110000110001011001000000101111101001110000001001101100110001
110100011111110011010011111111001110100100000001100001001100100010110011001011110001110100011101100111001100011010101000001100100111101100111001111011
100101111000110110010110100100011010001101101011001101100110111000100111101011000111100111000101110001101110111011111011111110101100100110100011000001
101100101010010110110000001101111011111000111110011000110100101111101100001001101100001101110100011011000010101010000010000010101101110111101111110101
100110000011110100011111100100001000001110100010110011100101100110001111011101000001101100010111001001111010101000111111011010100000010010001000000101
101111101001100101110001110111101111100011101000111111001101110000111010010101111111000101010001101100011010001111110100010010110111111000111011110101
100000111101001101000111000011001000001001001111100000011000011011100000110100010001110001011101101110110010100001100001110110000100001101110010011101
101010001100011001010110010110011101101100011100001111111111010001110111110001000100011101110100001000010111111101001111010011111101100100010111001001
101111100110111011010100111100110000111111001001111100010000011100110000010111111111000111000111111111010101000100011000011011000101110111010001100011
100110110011101010010101101001100111100011111011010001010111110110011101010011000011101110010001000110010100010111110011000001110100100011011101101111
101100011000100010111101001011110000001000001000000101000100000111000111011000011000100100111100010000110111110000010111111100100110111001001001000001
101001011101101110000000011010111011111111011111111111111110110001110100010011111110110001100001111111110000011011010011000110001100011101111011111101
101011110001101011111111111000010000110001001000101011000000111111100110111110000110011111001111100001011110110001010110010111111111010100011001000001
101001100101001000000000001111011110010101100010001001011110100010101100100000110011001100011000001100001000100101000000110100000100010111001101111011
100011001111011101011111100011000111000111110111101100000010101000101001110101111010011001010011111110101011111111011010100101010001010011100100110011
110110011010010001001000111010010011110011010011000111111010101110100011010111000011110011110110100010101011000011111110111101011011111000110110011001
111100111000111101101010001010111000111001011001010000000010100110111111010001110110000110100110101000101000011010000011110001001110001110010011001101
100001100011101001001011111010110010101101001101111010111110110100001101010100100111011100001100101011101111110010111000010111100100100011011001101001
101101001110001011011011000010011110100100011100001111100011100101100001000110110000010001111101101110000100000110001111000110110101110111001100101101
101101011100101110010001011111001000110111000101011000101001001100101111011110011011110111000000100011011101111111100011111100110101010001100110001001
100101001001100110110100010000011011100011011101000010101100011110111000010011001110000100011110111001110001000001111000001001100101011100110010111111
110101100011110010100111111111010010110110001111110110100111110010100011110111100100111110111010011100110111011100110010101100001101001110011000100011
100111111111111000101101000001110110100100101000010100110011011010001110100001101101100100001011000110000110001110011111100111111001100011001111101001
101100001011101111100001110100010100001101101011010101111000000011111000001011001001110001101000010011111100100011000011001100011011001001100110001101
100001100001000110111100000101000101101001111011011101101111111001000010111001011011010111001111111010011001111011101000011101010001101011110000101101
101111111100011100010111111111111101001011000010000001001100011101011110101101010010000010011000001010110011001000111111110001000100111000011111111001
100100010111000001000001100010100001101001011111111100011001000101111000101001000110111010110010101000100110011101100000110111111110011011000100010011
110001000001111011011100001000101100111101010000000110110011101100110011101011111111110010010110101110110100110101101110100010100011001110010101000111
111111111011100011001111111111100110000001011111011100011000101110100111001000010000011111010011101100100001100101000110001000001001100000110101110101
100010010001001001100100001000110011111111000001001001001111100010001101011111011011000101000110001001101101110100010010111111101100111111111101010101
101000110111011100110101011010011000100001010101100011100000110111111000000001000011110001111100101011111000000110111011110001100111100001000001010001
101110010001000110011101001011001110101101111101101110111110000100110011111101111110010100000101111000001101010011101001100100110010001101011101011101
100111110111110110110001101001101010101100001001000000100011110001100110000100110111011111110100001111100111111110001111001110011110111001000111000101
110000010010100100100111101011000000100111100011010101101000110111001110101110010100001000100111101100110000110000100100011011001100100011110001110101
100111011010101111101110100001111111110001111111111111001110011100011000101011010001101010101100001001111110000111110110110001100001101110100100010001
110001010000100110000100101100110001011101000000110000011011001001011111100001010111100010101101111011000111111101000100100101111111101000111111011011
100101000110110000110001100110000100000100010110000101000001100011000000001101000000101010000001000000010000000000010001101100000000000010000000010000
111111111111111111111111111111111111111111111111111111111111111111111111111111111111111111111111111111111111111111111111111111111111111111111111111111
