111111111111111111111111111111111111111111111
000100000010011000010001010010000101000000001
101111011011001101000100011000101100010110101
100110010011100001101111001111100101110011101
110000110110111101101001100000110000011000101
111111110100000100101100111110011011001010101
110001000110110111101001110111001111111110101
100101011110100010001011010001101000100010111
101101010000111000111010000100101010001010001
101101010111101111101000111110001011111011011
100111000101000010101011100011111010110001001
110001111101011010001000101000010010011100011
111100100000001000101110101111000111000111011
110001101111111111101000100010011101110010001
100100100100001000100010111010110000110110111
101101110110100011111111110010111010000110011
100111000100111001010001100110011011110011001
110001011110001111000100001111001010011001101
111011011011011000011111111101101011000011001
100001010000010011110000000001001001111110011
101100010111110110111111011011011101100010111
100111110000110010100001001110010000101000101
110000111010011010001101011000111010001111101
111110001111000000111000001101110011101000001
100011100110011110110011111001010111001101111
101010110011110000011110001011000110011100001
101000011000011111001000100011111100110001101
111111001111001100011011111110001001110111001
110001100001100101110011000110101101000100011
100100101011110111000110010100101001111101111
101110111011010001011110110101101100001100001
101100001000011101000000010000100111100110101
100111101101110001111101011111110000110000101
110001101101000111000111000110111110011111101
111101001001011110010110010000100011001000101
110001011011010000110011111110001001101010101
100111010011010111111001100011101101101011101
101101011001010010001100001001000111001011001
101101011101011011101111111101110100011001011
100100000001001010001010000001100101111101011
110110101111100010100010111111001101011000001
100011111000111110111110010101111001001011111
101001010010010000000011010000001011100001001
101100000111000101011000000110100010001100010
111111111111111111111111111111111111111111111
