11111111111111111111111111111111111111111111111111111111111111111111111111111111
00001000010000101000010000000000110001100101000000001000000111100000000011000001
10101111000110100010110111110101100100110001011011101110110011001010111110011011
11100000011100110110010000011101001110100101111010101100111001011011100000110001
10111111111001100010111110110000011100001100001010001001101100001011001111111011
10000000100011101010000000010111110111100111100010111011101111101110011000011001
10101011101110001111110111110011010000111100111110101000001010100100110011001101
11101001101011111000011100011001000110011001101000101011100000110001110111100001
10001011001000010011000001001101111111000011100011100001111111110100010100111101
11011110011011010111111111100001000111101010101110001111000100011101110110000101
10001100110001010011000100101111010010001000100110100100010001000100100110110001
10111001111101011000010110101000011011101111110011110101111111110111101100111111
10011011011001001101010100101011111001100000111000110101100001100011001001101101
11000011000011100111010110001010001100110110001110010100110101001001011011000001
10011110010110110001010100111011011110011111100111011110100100011100010011111011
10111010110000111101110110101001000111010000110000001100101111000111110110000001
10001010111110001100000100001101110100010110011111100101100101111110110111101101
11101000101011100111111111101100000101110111000010110101110100100010010000001001
11001010100010110010010000100111011100010011111010100100100110101011011111111101
10011011111000111011000111110101001111011010000010001110101110101010000110000001
10111001100011100010010000000001011001010010111111101000100010101011110011011111
10001100001001001111011111111111001011000110100011001010111010101000011000000001
11100111111011011000010000100011101001111110111000011110100010101110110010110111
10110110000001001010110111101001001100110010011101110100111010100100100111110011
10010011110101101110100110001100011110000111000100010001110000110101111100011001
10111000011100100100001100111111111011011101110111011011011011100101010001001101
10001111001001110101111101110000001000001000010001000010000010001100010111101001
11101001101100100111000001000111101110100011111101111110101110111111000001001011
10001011001001101100011111101100100100101000110100011000111000100001111111011111
10100010011011000101110010101110110101111110000101010011100011110100010001000001
10110110110001010100111000100110010100010011010111011001001110011110110101101101
10110100100101011110001010110011000111000110010011001111011011000010110100111101
10010101111101000011101010111001011110011111011001100001011011101010100110011001
11011101011001110110100010001101010000110000011111111101001010001000101111000011
10011001001011010010111111100101010111110101001000000101100000111011100111111001
10110011100000011010000000110101010001000111101011110000111111110001110011011101
10010110001111110010110110010001011111011110001000111110001100011100011001000001
11010011111000011010110011011111000001011011011110000110111001000111011101110111
11000110001011010010010111011001111101001000010011010010100011110100000100010101
10011100100010000111010001110011100101101011111001111010101111010001101111010101
11010001101111110011010101100110101100001001101101000011100000010111111000010001
10010111111000011001011101001110001111111100100001010110001011111100010011111101
11010010100010111101001100011010100000000110110111010010111110001001010110000001
10011000001010001001101001011010111111110010010001011010010000101011010011111111
10110011111111101011001011001000010001100111011101001111010110100010011000110001
10100111000010001110011011101011110100001101001101011000010011111111010010000101
10101101011000101100110010001000010111100001100101001011111011001101011110111101
10100001001110111001110111011110110001110100110001100010101001100101000111100001
10111101100011110011010001110010011100111110011100111110001100110000010100001101
10100100110110000110010100000111001110000111110110010000101101100101110110111001
10110110110100111100110111101101101011110100000011011110111001001101100000110011
10100100100101100001100000100000000000110001111000001000100011111111001010100111
10101101101100111011111110101010101111100100101111100011101010000001111011111111
10100100100110010010000011111111111000111110001000101011001110111100001111000111
10101101110011010110111001100001000010001011111010111010011000100111011000010011
10100000011001000110101100001101010111100010001010001010110011110011011011111001
10110111111101101100100111111001010001111000100011101110010110000110010001101101
10010100110100001001110000001011011100010010101010000011000000101100110111001101
11010110010111111011100110111010010111010111111111111011111110111001110100011001
10010011000000001011001100100010110101011100011000101001000111110011000101111011
10111011111011111010011001101110000001011001010010101101010010000111101100001001
10101001100001000011011011000011111011000011010110100000011000110101001110101101
10001101001101011010001010011010001001111110010110111111111110111100011000111001
11101100011001010011111000111010101011010110110010000001100000011001110010011011
10000111111011011110001101101010100001000100111011111100110111110011000111001001
10110010010001000000100111001010101100010101101000100110011100000111101110011011
10111011000101111111110001011011111111111100001110101111001001111100001010110001
11101001111100110001011101001000010100001001011100101001100011000001101000100101
11001101000111100100001001011111000110101111010001100011111110010100111111101101
10011100010100001111101011000001110010100010010111111010100011011110010000001001
10110111110101111100101001111100011000111011000000011000001001011010110111111011
10000000010100100001101101000110111111101001111111010010101100010010010001010001
11101011010110101101001001010000100000001101000011010111111110110111011101000111
11001001010100100111011011011111101110101101011001011100000000100110000101110001
10011101010001110110010010011000001010100100001101001101111111110010110100011011
10111001111111000100110110110011111010111111111101100101000000011000111111001001
10100011000001010001110110000111000010110000011000110001011111001111100001101101
10101111011100011111000100101110011010100101110010011111010001100000101100001101
10100000000101000000010101100000110010001100000111000000010100001010000110101000
11111111111111111111111111111111111111111111111111111111111111111111111111111111
