111111111111111111111111111111111111111111111111111111111111111111111111111111111111111111111111111111111111111111111111111111111111111
000101000010000010010000001111000000000011000000001010001100010001101010000100000001000000001100000001110001010010000000001000000001101
100001101000111011000111100110011101111010011101011000100001000100100010110001111101011010101001110100100100000110111101100010111111001
111100111011110010010001110011110001000011111001000011111011111110101000011011000101110010111011000101101111101110110100111110011000011
100110010010000110110100111001000111011110001111011110001000011000101111110011011100010111100001101111001000100010000101100110110010111
110011000111011111111110011100011101010000100110000000111111001101100000011001000111010110001101001000011110110111110100110000100110001
111011111101001000001011000111110100010101110011111111100001101000111111001101010010010100111111011011110100010001000110010111101100101
101000001001100011100001101100000101110100011000110001001101001011100010011101011010110101100001000011000101111100011111011110001001101
100010101011111110111101001001101100010111001110000101011001011010001000110001011000100000101101011110010100010111110001000000111011001
101110101010101100010100011111000111010011100011111101001011010010111111100111001101111111101101001000110101000000100101011111100010011
100100100010000001010111110000010101011000111010000001101010010110011000001100011001010000100101100011100101110110101101111000110111111
101101110110110111000101100101110001001101100011101111001000110111010010111111110011000110110100111010001111100011101101000010010000001
100101100100110101110001001100110101100111001111001000011111100101110110100000011010011110010110001111011100001001001001101111011010111
101100111101100101011101011110011111110100011010011011110000110101100110101011010000110011010011100110000110101111011011100011001010001
100110000001101100001101000011010000000101111010111010000110100101001100101110011111111011011010110011110100111000010010001001101111101
110111111111001110111001111110010111111101000010000010111100101100011111101000110100010001010010011010010110001011110110111101000001001
100100000100011000000011000010110010000101011111111110101001101110110001101010100101000100000111001011000111011000100110000101111101101
110110101101010010111110011010011000110101001000100000101011100110000100001010110001111111111110011011101101001110110011011101001101001
100010100101111110100000110010111111100001101010001110100010110011110101111011111111100011000010111000100001100010011001001101101001011
111010110100100010101111110110100000111111100010101000101110011000010111000011000010001001110110001110110100001011011101100101000011001
100000100110001010001100010010001101100000111011111011101000111111011100010110011000111100100100100000111111111011001000111101101111101
101101101111111011111001011011111101001010001001010010000010110001011001011100111110101110110101111111100000011001101010000101001010001
111000111000010001000011010000000000011111101111000111111110010101010011111001110100001000100000110000111011001111001011010001011000111
110010011011010101011110010111111111111101001100011101000111010101010111000011000111011011111011100110010011100011101111111111001010011
100110110010010111011010111100011010001001011001110000010010000101010001011111010010001001010000110111000110111000100111000011100011001
101111100110110001001010011001001010100011011011011011111010111101010100010010011010101100011110100010011100011110110010011010111111101
101101001110111011101011010011101010111001000010000001100010001111010111111010110010111111000110111110111001001010011000111010000001001
111000011000100010100001000110001000001011111110111101001111100100010001000010100111100010010100000110101011100011011111100011010101011
100011111011101110001111101100101110101000110010000101101010110101111101101010101101001011010111110000101011111010010000001110010111001
110110000010000000111000111001100011101110100111110100101000110100110000101010101000011010010000011111101001011010110101011000110011101
100111110110101111100010011111101000111000101100000110100011100110011010101110101101111011111010110100001101010010011101110011111010001
110100010111101100001111000001001110100010101001111100101110001111001110001000101001100010001110010001011001010111000101100110011010111
110001010001111001101011111101100110110110001011100110111000111001100111011011101011001110100011010111010011010001110001001111010010001
100111011100010011111000010100101100100100111010001100110011100011110011001001000010011100111000010001110111011101011111011101010111101
111100010111000111110011000110111001101110010010111101100110101110011001101101011111001001101111111011100001001000001011010000010000001
100001010011111111100111110110110011000011010110010001001100000000111100111001110001101011100000000000101100011011011000011011111111111
101111111000000011001100010000000110011001110011010101011111110110000110011100010100001010001011111110001111110011010011111000100011001
101100110010111001011001011111111110111100011011010111011000000111110111000111010111111011011001000010111000011001110111000010001001101
100110010110010011010011110001100000100111010010010010010011111100000001101100010000010001111101011010001011011100010100011110111100001
110011000011011110011000010100110110110001010110111000110110001111011100100110111111010100010101001011111011001110110111011000100111101
111001111111000010110011010110011100011101000100101111100010100110000111110100101000010101010001101001100001100110010001110011101101101
100011000100011000011111010011000111000101111110000100001110110010110010000110100011111111011111001101001111110011011100000110001101001
101010010111111111000010011001010011110101000110110101011000111010011010111110110110100001000011011101011011011001001111111110100101011
101010110011000011111000111101111010010101010010100101010011100011001110100100100000101101011010010001001000001101101000101000101100001
101010011000011000011110100000101011000100011000101111000110001001111100110001111110101101110000110101101101111101000010000011101001101
101011011111111111000111101111100010011101001101100001111100101101000001111011000010101000010111100101001001100001011111110110001011101
101001010001010001110001001001001110110111111100111100011001101111011111100001101110101111010110101111011100101101001100010011011000111
101101000100010100111100011101011000000011000110001111000011101000010001001111000010001100010100100011011110100111100111011001111110011
101101111111010110001111110001001111101001010010100001111110001011111100011001101011111001110001111010001100101110110000001100000111001
100100010001000011011000111011101100111100011010111100000110111010001101110011001001101011011101101000100110100100011011111001010001101
110101110101111110010010100010100110010111111010100111110010001000100100011000011100101000001001001011110000110101111110001111011101101
100101000100000011010110111000110011010001010010001110111011111111110110111111000110001111101011011001011101100101000000100010010101001
110101011111011001010110110010110110000100010111100010100011000101010100010001111111011011001011001111000101001100011101101000110001011
100111011000010011010100000110010011010111010000111000101110010000010111010100000101000000011001101000010111011101111001111111111011001
101110010011011110010111111110111001110100011110001110100110111101110100010111110001011111111100001011110110010100101011000000010001101
100100110111111000110110011000011100110101000011101100110010000100000110110000111101000001100110101011010100110110001001011011010111101
110101110000100010100100110011001110011101110111001001111011110111111100011010001001111100110011111001010101110111101011001110011100001
100101010111101111110101100111100011010001000010011011001000010001011001011011111011000110011000001101000001010100001010011000111001111
101100010000100001010101001111110111011011011110111111100011111101001111000001000011101111001110100001111111010001111010110010010011001
101111011101111101000100011011010100010011111000000001001110001101100001011111011110100011100000111111100110000111000010010111010110011
101000010101010101011101110001000101111000101010101100011000100100110101000010010100001001111111101000101100111110011010110101010110111
100010110100000101000111000101110100011010001011111001001011110110000101101110110001101100101000001010001101101000110010010001010010001
101111100110111101101110011100011110110010100010001101101001100011111101001000111011111110000011101011011001001011100110111101011011101
101001001110000001101100110111001010100110101010100111001101001010101001101011100000100011111110101001001011101001101110100101001000101
101100011011111111001001110001100010101111111110110010011101011000001011001001001011101001000110001011011000001100111000110101111110001
100110110010110000011011000111111010111000000010111011110101001111101011111101111010001101110000111001001111100110001110100100011011101
110100111000010101001000011100000010010011110110101001000001100010101000000100001000111001100101101011100000110111100100101111000000101
100110010011000101111101010001111011000110100100101100011111111010001111110111101011100011001100001000111010110010110001101011101111101
110111000110010101000001110111101011111100101101100111110000001011100001010010001000101110011111111010010010011000011111000010100001001
100001101110110101011111100100001010100001100001001100011011101000110100011000111010101000110110000011010111011111000110011000101101011
111100111010110100010100001101111010001111111111011001001011001110111111011111101011101111110000111110010100001011110010111101111001011
101110010000011111010101111000001011100000110001010011100010011010000001110000001001000100011011100011110101111000111011100001100011001
100111011101110001000100001101011000111010000101000111111110110011111101100110101101011101001000101001000101100010101011001101001011101
110001000111100101110111011001001110010011111101101101101000111000000100001110111001001101101011101101101111001110001001011101011110001
100101110100001100010001010011100011000110000101101101001011101101110111111000110011100000100010001001101010011010111101010001001000111
110100010101111111011111011000101001111111110101001000011001000001000100100011100110111111111110111100100010110010001101011011100011101
100111000100110001010000010011111100001000110100011011111101011101110101101110001100000000000010000110110110011011011001001010111110101
101101111110010100010111110110001101100010000111111000111001001101100100101000111111101101110111110110000111000001000011101010000000101
101000101011010111110000110010100000111111110110000010010011111001001101100011101000100100110100010011111101111101111111001010111010001
100010100000010101011110011010111111110100010100111111000111100011011000111111000010110110010001011000001000011001100010011110100011101
111110111110110100000011011110110001100001010101110001111101001110010011100001110110100111011111111111100011110011001000110100101111001
100010000010100110111001010000100100001101110101000100110000011000111001001100000100101101011000110011001110000111111101110101101001101
101011111010110110101101011101101101011111000100011110100111111110101100011111110110100001001010000110011000111100010000010100101100001
101111001010010000100101000100111111000001101111111000001100101100100101010010111100101111101011101110111011101101011101000110100111011
100101011011011111110001010110010001110100001010001111111110000001110001011000011001100100001001000010110010001001000101110100110001111
110100001000011000111101010111000100100111111010100100010100111111000111111011001100110101111101011010011010100011110100010001111100001
100001101111110010011001010011010110101101100010110001000101100000011100110011100110010100010001001011000010111010000111111011000101101
101111100001100111001011011001011100101100001110111111101100101110110001100110110111011101000101101011111110001111101110001110010111101
101000101011001101101010011101001001100110111000100010100110111000100101001100010001000111101111101001100010100000101000101100110000001
101101111010011001101011000101101011110110100011101000110010010011111101011110111011110000101010001101001000101110100011101001111110101
100101000000111100101001111101111010000010101111001101100111000110001101001100001000011110101010111101011111111000111110100011000111101
110101011111110110001100100001000010101000101010011101101111111100100001100111011111001100101010001001011010100011100000111110010011001
100101000000010010111110101101110110111111100011110001000110001101101111110001010001101001101011101011001000101110001011100010111000011
101101111111010110001010100111000100100001111000111011010100100000111000011101000100100011001000101001100010100011101000001010011111111
101100010010010111100010110001011101101100001110010010010111111010010011001101011110111111011010101111101010101000101101101110110000001
100101011010110000101110110101001000101110100011010110110000010010110111100101011000100001011110101100001111111010111000111000100101101
110001000010011110000110010101101010100010111111010010111111000111100110110001010010101011000000100001111000001110001110110011101111001
111111111011000111010011011100101011110110100000011010100001110110001100011111110110101001111011111111000011100100100010100110000001011
100000110011110001111110001110101111000100101111110010101101000010111101011011000011101100100001101001101110110111101010001111011101011
110101100110011101000111100000100101010101100000111010111100011110110001001000011001001110001100000011001010010000101010111110001001001
100100101111001001010010111111110000011101111110000010011001010010000111101110110011011011011111111010011000111110111010110100111011101
101101101010011011011000010000010111110001000011110111001111000110111110001000100110010001110001100010110010000010010010010001101001001
101001001000110010001111000101000110100100011001000011100011110111100011011101101100110111000100101110111011111011010111010111001101011
101011011101100110111001111101011100101101111101011110111000100011001010010001000101110010010110100100100001101001000110010100011101111
101000000001101100100011000111001101101000101111000010001110101001101010110111110101000110111100110101111100101101111100110101010100001
101010111011001101110110010011100001001111100001111011100010111100111010010000110100010010011001111100000110101101001101100101000101011
111111110010011001000110111010110101011100001100000001001010000110010011010110010110111111001100011001110100100101100100101111101101001
100000010110111011010100100000110111001001011111110100011011011111010110010011010100100001100111001011000101110001110110101000100111101
101111010100100001110101111010010100011011110000011111111001001100010010111011011101101100110001101111101100011011000010100010001100001
101000011101101111000100001111011101010010100111001000001111100111011010110001001000100110011100100010001001001011011010111011011001101
101011111001001001011111100001010001110110101101100010100010110010010010011111100010101111001110111000111101101001001110001111110011001
101001100011011100000000111101000100110110101100111011111000011010111011000000101111100101100100101111100101101101100111100000010111011
101100001110011001111110100101111111100010100110000010001111010010001001111110100101110101110001100001001101001000110000111111000110001
100111111100110011011000110100001100001000110010101010100110000111101100011010110001000100011111101100011001011010011101100001111100111
110000001001110110010010110111100001011111111011101110110011111101001110110010011011011110110000001111000011001111001001001100000110001
110111011011000011010110010110111111110000101000101000111001000001011000000111011110011000010111111001111111100001100011011001010011011
100001010010011000010111010000000000110110001110101011101101101101001101101111010000110011010011001100100000111101111011001011111001001
101011010111111111110100011011111110010111100010101010000100101101011001000010010101100110011001101110101110011001010001011000101101101
101110010000110000000101110010001100110100111010101000110110101001001101011010110100110010111100100000100011000011010111001110000100101
100100111110000111111100000110100111100110001000111111100010101011100111001010011110011010000110111101111001111111000001100111110111101
110101101011111101011001111100110010001100101011110000111010101010110011101011000111010011110010000101001011000010011111101100010001001
110100000001100000010011000001111010111001100001100110001010111000011010101111110001011010011011110000011001101011110000100110111101011
100101111111001110110111011111000010100011111101001111101010001101110000001000111100010000110000011011001101001000111010110010000101001
101100010000011010100101010110010110101111000111011011001011100100000101011010001111110111100111001001111101011010010010011010101101101
101111010111111010001101010000110000100100010010001010011010110101111101110011100000100001111110011100110001011111010111000000111000101
100011010010001011111001011111111111110101111000101000110000100111000111100110111110001111000100111101100101001101000101111111110010101
110110011011100000011101001000001100011100001011111010111011101110010000001100000111111100010001111000101111101001111101000100000111101
110100111001001011010001100011100001000111101111000010010001101100111111111101111100001001111011010011100000100011000001010001111111001
100101101101111001010100111110111111110000001000010111110111001001100010000100001101101011101010000110111101111001010111011101100010011
101101100100011101000101110100011000011111111011111100010011011011001000110110100001001000100010111110011001011101010001000111001000111
100100101111000101111100010001001011110110001000011001011010001011011111110011111111011110101010010000110011000101111101110110011111101
101110100011110101000001011011101000000100101110110011010010111010010101011001000000011010101111011010110111010100010001010010111000101
101010101000110111011101001010101111010111101010100111000110110000110000011101101101001010111000001010010101010111000100011000100010101
100010001010000000010001100010000000010000000010001100010010000110100101000000001001100010000010100011010000010000010101001010001010000
111111111111111111111111111111111111111111111111111111111111111111111111111111111111111111111111111111111111111111111111111111111111111
