11111111111111111111111111111111111111111111111111111111111111111111111111111111111111111111111111111111111111
00010000010110000001100000000010000000100001010100000000010001010011000100010000011010101100000000110101011001
10010111010000101100111010111011111010101100010001011101010100000110010001010111010000100110111111100001000011
10110110010111100110010010010010001010000101010101000111011101010000111111000001000110110010000100001101101011
10111100110101110011110111011000101010110101011111010010000111110111100001011111101100011000110101011000001001
10001001110100011000010011001110101111111101000001111011110001100010001011111000101101111101100001001111111011
11101011010111001111011001100011101100000001101101100010111101001011011000100010001000011001111111100000001001
10001000010100011001001101111001000001111111111001001010000001011001110010101111111111010011000001111111101101
10111011000001010011100101001101111111000000110011011111111101111100010111100111000001011001011011000001001101
10001001111111000111110101011101001011101101100111000100011000001111010001110010010111001111010000011100011001
11101111000011011101010100001001011000001001001101110101001111100110011101011011010001100010011111110111110011
10100000011010001100010111101011000011101011011000110001101100110011000001011010011011111000110001000011000111
10111111110010111001010001101011101110001010010010011011000101111001111100010010111000001111100100011010011101
10000010100110010011011100101000100010101110110111000001110100001101001001010110101101101001001101001010110101
10111000101111010111001110001110111110111100100001111100010101011101100011110110001101101101011001101110110001
10011110100101010101100010101010010000110001101100000111110101010001001110000100111001000001001100100010011011
11010000110001110101111011100011011011100111111111111100010101000111011000111110100011111011100111110111000001
10010110011100010100001000111001011010001100000000110001000101111100001011100011101010001110001100010101111101
10110010110111000111011110001101001000100111011110100111110100110101101010001001101110100100111001000000100001
10011011100011111110001011100111101111110110010110101100111110000111111011111100001000110101110011111110101111
11001010001000100000100000110000100001000010110100000110011011110010110010001110111011100101010110000110100001
11101000111110001111111110111110110101111010110001010011000000011000100110100100011010001100010000110010111101
10101111110011101000010110000010011100011010011111011001101111011110101100110101000010111101111111111011101101
10100101011000101011010011111011011001001011010001011111000011110000101001100111111010001000110001110000001001
10110001001110100001011011000001001011101011000101010001111001100101101011110000001110100011100100100111011011
10111101100000111101001001101111101000101001101101010100001100001100001000111111100110111111001110101101000001
10000100110110010111101100000010001011101100100101110111100110100111111110001000110100001100011010100101111111
10110001100011000010001001111110111110001110110100010100110011101100000010111010000111011001110010110000100001
10011111001001111110111111000010010100111010010101000001111001111001010110100011111110010011000110111111101101
10110010011101100010001100011011010001100011011111011101101100000011010000101110001000110111101110000001101101
10011000111000101010100001011001000111110111000011110000100111111110010101101100101111110100000010110100100101
11001101101101101010111111110011111100000101111001100110001101100010111111101001100000100101011111100110110101
11100101100001001010010000100110000001110000011100111111101001001011100000101011111101101111001000101100010101
10110001001111011011110110101111111100010111010110001100001011011001101110101001000000100011101010111110110101
10011111100110010001100100000010000111111110000011101001111001011100101000101101011111111010001010001010000101
10111000001100111100001111111010110000100000111000101100101101010110101011101101001100010000111011100011011101
10100011111001110101100110001000111110001110101011100110001001010000101001100001100001000111100010111010000101
10001010100011010000111100101111100011111011100001110111100011010111101100101011111111011110001110001010110101
10111010101110000110100001100001001011000001001011010001110111010001100110111010100011010000111100101011110101
10011000100111101111101111111011011001111100011000010100010010011100110100010010001001110111100001101001000101
11001111110000100110001000101010011100000111111111111111011110110110010101010111011101000101111111001101110101
11101000011010110100111010101000110111110000011000001000010000100111000111010000000111011101000010011100011101
11001011010010011101100010001111100100011110110010101011110111110101111110011111011110010000011000110111000101
10011011011110111001001111100101110001001100100110101001000100000000100000110001001100110110111110100001110101
10110010000000100011101000111100011011011001101100111101011110111011101111111101100101100010110000110111000101
10100111101111101110101010011001000011110011001001100001001000100010001000001001110101001110100111110010011101
10101100101000001000001011001011111000100110011011101111101011101110111011101011000101111000110100011010110001
10100110101011111111101001100010011110101111001000100010101000101100110001100010011100100010100001000010100101
10110110001001100000001101111111001010100110011010111000101110101001100100111010110110110111101111111010110101
10110010101011001101101001000001100010110010110010001110100100111011101110011110100010110000111000110010100101
10011010111010011001001011011111110110011010010111101010110110100010100011010000001010011010000010100110101101
10111010011011111101011010001100000010110011010001100010010100001110001001000101111111001110111110111100100101
11100011010010000101111011100101111010111000010101001011010111011011011111111101000101100100000010001101101101
10001001110110110100101001110100110010011111111101011110010010001010011000001111010100110111111011100101001001
10111101100100010110001101010001100111000001001001000100111011100011001011101000010110110100010000110001111011
10000111001111010011101100011011001100010100011011011101100000111001111010100011110110100101000111111111100011
11011110011000011000100111001110011111110101001001110001111110101100000010111110010100001101111101100000001001
10001000111010111110110001100111001010000111101100100111010000100111111110000000110001111001000001001111011101
10111011101011100000110100110101101000101110101101101110000111110101010011101011111111000011101100011101001111
10100010100000111011100110100100101011111000101000100011010101000000010110001110000001011110101111110101100001
10101110001010001000111100101110001001010011101011111000011100011011010000101100101101000010001000000000111101
10100100111111101110001101101100101101000110001000001111111001111010010101111001101101111010111011111110101101
10110101100000001010100101000101111001101110111110100010100011100010110100000011111000001010011001000010001001
10110101101011111011110101010001000011000010100011101010101110101110100111110110001011111011001011011010111011
10010111001110000001100100011111011110011010001001001000101100100100111100010010101000010011101110010000110001
11010001011100111100101101111000010011010011111101011101100001110110001101011110101110110110101000111111100101
10011100010110100110101100110011110110010110000001000111001111100011100001000000100000100100000010110001001101
11001111110010101110001001100111010100110011011111110010011000111010111111111111111110101101111110100100011101
11101000011010100011111111001100000101111000001000100110110010010010110000000000001100100101000011101111111001
10000011001010111000100000011110110100101010111010001100100111000110000111111101011001110101011000100010001111
11101111101010001010001011110100111110101111100011100101101101111111011100000101000011000101011110001010100001
10001000100011101011111011000001100000100110001110110100100100010001111001010101111110011111000011101110111011
10111110110110001010001001101011101111110010111000100110110001000101100011010101001000110001111000111100001001
10000010010010111000101100101000101000011010110010001110011111111101001111110101101011100100011010001001101101
10111011011010001110100110111010101011001010011111100011000110101100011001000100001001110101001011100011111101
11100011000010100110110010001110101011101011001000111011110000100111111101010111011100100111101000101110000001
11001110010111110011111010100010001000100011100010001001011110110100100001011110000110001110001011111000101011
10011000110001011001100011111011011010111001111111101101010100100001101101000100111111111000101001100011111001
10111111111100001100101001010010010010001100010010001000010101101101000101110101100001100011111111001010001101
10001100000111011110111100010110110110100111011010101101000100111001011100100111001100001110010000011010101001
10100101110011001100000111010100011111110101011010111001111110011011001001101100011111111011010101111110101011
10111101011001100111110001110101110000110101000010001100100011001011101011000001110001000000010100011100101011
10100001001100111100011100010100011010000101111011100111101001101010001001110111100101111111000101001001101001
10101111101110001001000101000111011011111100011010110000001011101000101100011100001100010001101101100011001011
10001010100011011011101111111101001001100001110010111111111000101111100111001001111111000100111101101110011001
10111010001001001010000110001001101101001111000110001000100010100001110101100011010101110110011000111000111011
10101000111011011010110010101100101001011000011100100010101110111100110000101011000100000011001010100010100001
10001111100010010010011000101001100011010011110110111110101100100110011110111001011101111111101111101111110111
10100100001110110111011111100011111110010110100010100010100110110011001010011101010001100011000110001001100101
10110001011000110101000001111110001000110010001011101000110010000111101011001001000111001010010011011100110101
11100111110010100101111101000000100010111010101001001110011010110110001001101011110110011010111011010110010101
11001100010110101100100001010110101010100011101100011010110010011100111101101000010010110011111010010011000001
10011001000111101001101101010110111111101111000111110000010111001001110100001111011010111001110010111000011011
10110011011100001011101111010011100001100100011101100111110010011011000101111001010010011100100110110011111001
10100111110001111010100011011001101100110001111001001100011011001011011101001101011011001110101110100110001101
10101111100111011000111000011100101110011111100011011001011001111001010001100101001001011000100010111110100101
10101011001100010010001111110110001011000100101001000011001100001101000111110001101011010011111010000100110101
10100000011101010111100000100011111010010110001101111111101111100101011110000100101110010110001011110001110101
10111111111001011100001110111010100010110011011000100001001000110101001000111101101000110100101000110111100101
10010000100011000101111010001000101010111000011010001101011110100101101010011000101010110101111110010011001101
11000110110111110001000011100010001110001110110011111101001100101100100011001111100011100100000011011001011001
11111110100100011111011001111111100111101000011010001001100001100110111111111000111110001101111001001101011011
10000000110101000000001101000000110101001011001110101111111101110010001000100010100000111100100011100101010001
10111111100101111111111001010110110101011001100110100000011001010111101010001110110111100110101111110111011011
10000101001101010001010011011100100101001111110010111011010011010001001011111000100110110000100101010011010001
11110100011101010100010110001001101101100011111010001011110110011011011010010011110100110111110100011001011101
10100110110101000110110110111011001000111001101111011000010011010011011010110110000101100001000101001101011001
10001110100101111110010100011001011101101100101000001110110110010110000010100011011100001011011101101101010011
10100000110000000000110001001100000000000110000010100010000000110000101010001000010001011001000000100000010110
11111111111111111111111111111111111111111111111111111111111111111111111111111111111111111111111111111111111111
