11111111111111111111111111111111111111111111111111111111111111111
00001010000100000001000001101000110100000000010000110101100011001
11101000101101111100010101001010010101101011010110010000001001011
10101011111001100110111101011011000000101110000011011011011101001
10001010001011001100111000011001111111100011111110001011010001011
10111000100010011110010011001100001101111000100011101110010111001
10010011111110110111011001111110100101001110001001101000110011101
11011011000100000101001111000000110001100011111100100011111010101
10010001110001110101100010011111111101101001010110111110110010001
10111100111101010000111000110010000100101100000110011000000110111
10001110100001011110101111111010110110111110110011001111101100001
11101010111011000110000000001010010110000010111011100011001101011
11001010110010010010101010100011010011101000100010111001100111001
10011000010110111000111111111111011001001111101110001100110000011
10111011000100011011110000000000011101011000001011011110111111001
10001001111111110000010111111111110001110010111010000010011001101
11101111000000011111010011000011011011100111100010111011001100101
10100011101111000010011000011001001000110101001000100011101101101
10111001101011111010110010111101101110100100011111101110001001001
10001011001000001011100111100001000100110101000001111100111011011
11011000011101111000111101001111010001100111111100001001110001011
10001111110100011110001000011001011111110010001101011011000100001
10100001000101000011100011111101010000011000100111001011111110101
10111011010001111000111111010001011101001111110000011000000011101
11100010011111011110011000010101010001100000011111011101011001101
10001010110010000011001011000111010101111111001000000111111101001
11011110100110111001100001110011000111000001101111110100001001011
11000100110100001100111100111001111110011100100110010101100011001
10010001100001011110000110101101000011110001110011000101111111101
10111111001111110000110110100101011001100101011001101100011000111
10010001111000000111111100110001001100001100011100111001001010001
11011101000011010100001001110111011111111111000110001101100011101
10001000011111110101100011010100000100000101110111100111001110001
11100011110001100100111010010111010111110100000101110001111000101
10111110111100001110001111010001110000100101110101011100010010101
10010000011001111011100011011100100110101100011100001111010111101
10110111001011001000111001010110111100100111001001100001010001001
10000001101011100010011101000110110001110001100011111101011101011
10111111001000110111000101010100100111100100111110000101001001001
10001000011110110001110101110001101100101110010011101101101011101
11011011000110100100110100100111101110001011000110000101001011001
11001001110100101110010110110000100011100001010000111101011001101
10011100011101101011010010011110101011001111111101100001001101001
11010110110001101000011011000010111001100110001100101011101001011
10000110010111001011010001111010001100111100100110001110101011011
10110010110001101001111111000010101110000001110011101000001001001
10111110010100101011100001011111101011111100011000101011111101011
11100010111110111010001100010001001000000101001010101001000001001
11001010011000100010111111111011011011110111111110101101111011101
10011000110011110110001000000000000010000100001000100100110001101
10111110010110000011101110111111111110111110100011110110010111001
10100010110110101110101100001100001010000010101111000011000110011
10101000010011100000100111111001101011111010111000011001111100111
10111011111001101010110000010011001000110010001011111011000110101
10001011011101001011111110110110011011100111101000110000010010101
10101001010001011000110010000010111000101101001111100101111110101
11101101010111110010011011111110010010000001011000101100110000001
10001001010100010111000000011011011011111100011010111110010111111
10111011010001010001101111001001001110000110110010010011010110011
10010000011111011111001001101101100010101111100111000111110011001
11011111010101000100011011000000111000100011001101110100011011101
10010001110001110110110001111110011111101110011100010101001000101
11010100100101100000100100010111000100101000110001010001101110101
10000110001100001010101101000000010001100010000101010100100000000
11111111111111111111111111111111111111111111111111111111111111111
