111111111111111111111111111111111111111111111111111111111111111111111111111111111111111111111111111111111111111111111111111111111111111111111111111111111111111111111
000010001100000001010101000011010000000011001100010110010000010001100110110000000110001000110001100000000000000010000110001000000100010100100000000000100000011000101
101010100110101100000100011001010111101001100101110000110111000100110000100101101100100010100100111011011110111110110000101010110111000101101111011110111011000010001
111011110000101111110110111100010000101100110001000101110011011110011010101111100101111110001110001110010010100000011101111010110000010001101001000100001111110111011
100001100111101000110010011111111110101101100100010100010110010011000010111010001100000111011011100100111000101111110001010010011111111101001011110101100000010110001
111100111100001010011011001000000000100111001110111111000100111001111110011000101111110101010000110001101101101000010111000111010011000001011000010101111101010011101
110110001001111011110001101011111110110001011100011011111101101100000011001101111001010101011010000101000111001101110010010010010110011111001110110111000111011000101
100011101011000000010100001000100011111100011001001000010001001001111001100100110011000101001010101111010011011100010110111010110000111000011000100100010001011011101
101000101011111111000111111110001001101111110011101110110111101011001100110101100110011101101111111000011001000111010110001110011111101011110010101101111101001001101
101011101010000011011100000111101100001000011111000100100100001000011110110001001100110000100101000010111101110001010011100111000000001000100110100101000101101100101
101110001010111001001001010010100111111011000110010001101110111111001010000100011001100110110000010110100100111100011010110011111111101110101100101101110101000111101
100100111010001101101011111000110110001011110011111111001000100001101011111111110011101100011011111100001110010110111000011001000001100010101110101000010101110000101
110001100011100101101000101110000100100010111000000110011101101100101000010010000110101111001110001101100011000000100011001101011011001010100100100011000100011010001
110111001000110100111110100011111101111110001111110100110101001110000011011010111100000110011000100111101001111111101010011001010010011110110110110111111101001111101
100101101011110110001100101000000100001100100001000101110001011011111110001010110111110100110011110001001100010000101111010011010110110100110100011100000111100001001
101100001001000011011001111110111111100110101011011101011011011001100011100010010001100101110110011101011111011110100110010110010010010001100111001111010001001101101
100111011011011110011011000010100010110011101001001001001010001101001010111011000100111100010011000001010001000000110011010110111011000111101101100110011101111001001
110001110011010010110011101000101000011001001101101011101000100001011010010011111110001001011001101111110101111111111001110010001111111110001100001100110101000011011
100100111000000110010110001110101111001101011000001001000011111111001010110110000011100011001101000000000100010001011100011011100101000000101001111001100100011111001
101110101111110011000100100011101011101101001111111101101110000100011010000111111000111111011001011111111111000101010110110000110000011111111111000011001111110001011
111010100000110111111111111010000010001001011000000001000100110101110011101100011010101010010011110000000011111100000110011110011011001100001100011111011000010100001
110010001110010010001000011000101110101011010011111011111101110000100111000001010011100000110111100111110110000111110011001011011001100101100101110000011011000111111
100111111011011011100011001101111000101001011110001011000100011111101100011111000111001111110111001100100100110000111001100000001100110100110101010101001011111110001
101110000010010011001001100111010011101101000010101000010101000110001001110001110010011000010010011110101101111110001100101111100001111110110001000101101010000011011
100010111010111001011100110011000111001001111010101101010001101100111111000100111010110011011010110100100100110011100110100000111111000100011111101100111011101001001
101110001000101101111110011001010100011011001000100111111111111001100000011110011010000110001010000001110110100111001110101111100000010101001100001001110010001101011
100111101111100100011111001100010111110010011111110001000100001011001111110111001111111100101011111011000010101110011100111000001111110101100111011011000110111001001
110000100001110101001101100101110100010110111000011100010110100001011000100001100001100001101011001001011110101000110001110011111011010101110110010010011100010011101
100110111011010101100000110100111101010100101011110111110000111111010010111011110101001111111010011101001100001010110111000111000001010100010011110110110111010110101
110110001000010001111110100110011001000110000000010001100101100001010110110010000101011000010010110001100101111010010011101110011100000111111010000110110000010000001
100011011111011111010110110011110011111110111111000101001111001011010010000110111101010011010110100111110000110011011010100011000111111110000010110010010101111111101
101111011001010001000000100110000110101010101001111100011000011000011011110010001111010110000100001100011010100111010010001001110100000000111110111011010100011000111
100100010011000101111010101100111100000010100011000111110011111111111010011011100001010011110111111001001110101100010111011100100101111111100000100001011101010010001
110101000111111100001110001101110110111000001011010001100111000011000011011010111100011000100100010011100010100111110001110110110001001000101011101101000101000111101
111101010010010111100111101001010000011111101001011100101100011000011110001010000111111110111101000110111010110000111100100000011111100010001001100111110111111110001
111001111011000101110000101011010111110000111111010110101001111111110000100010110001000010110001111110100010011110001110111101000101101111111100110100010100000100101
110011100001110000011110101010010110010110110000010010101011000011000111111110111100010110000111100010001011000011100010000101010101000010000110011101000110110001101
100110001101100101000110101011000011010110000101110110100001101001011100001010001001110011111101001010101001111001111011110101110100011010110111001001111100111111001
101100111001001111010010111001101010010011101100100100111111001011010001100011101011011000010100011010111111101011011001010111000101111110010101101011000001100001011
101001110011011000011010011100111011011000111110001101100001011110010100101001111001001111000101110010000000101001001100010000010101000111010101101011011101001100001
101111100110001011111011000110011000011110011011101100001100011100110110111100001101011001110100110111101110101101101001011111111111010001010001001001001001011111111
100000101111111011001001110011001111000100110000111001111111001001111100110111100001000011000110100010111100100101001011000001001000010100010100011101111011000100001
111110101000100010011011011001100001101101100110001011010101101011101001100010111111110111101100111010100001101100011001111100011010110111111111000100011001101101011
100000100010001110110000001101111100111001001111101001010000001011000011001000010000100001000110100010101101000001111100000110111010111100001101110111001011100101001
101111111111111010110111111001000001110011011000101101000111111010011110011101000110110101011110101110100111111101000101010110100010000101100100100101101000110101101
100010001001100000000110000011010111100110001010001101011100001000110011000111111110110101010100101000110110000111010111010011101111010000110101101100101110111100101
101000101101001011111100111111110000110011101010100001011001101111111001101100010000000101000001101010110000110000010001111000100001111111110101001001100100001110101
101110100100011001000001101000011010011000101111111111001011001000000011000101011111010101111111100010011111111111110100011110110100100010000101011011110110100100101
101011110110111101011111000011000011011101100101000011100001100011111111010001000001111111010110111110110110001000011110110000010110101011011100010000010010110001101
101001010010010111000100011111111111001000110000011000111111001110000000011111111100000010000100011010010000100011001000100101110011101001010001111011011011100111001
101100011011110001110101001000100001101011111111111110010001111000111111111000101111111000110101000011011010101011101011110100111001001100011101011011011000111100011
100001001010000100010111101110001111001001110100000011000100110011100011010010001000101110010001110111000010111000111011010110000011011111111001010010001110011001001
111111101000101101110010000100100001101100100001101111111110000110001000010111101010001011011111000010011111110010100010010011111110011000100011000111101011001011101
100011101111111000011011010111111100101110001111000110001011111100111111010110000011100001000001101010110000011111101110111011001000110010001110011100100001101010101
101001001100011111001001110000001110101011111100011100100000001101110100010011011001111101110100111010010111000010001000100010011011100111111000110001110100101000111
101100011001000011101100100111101010100010000110110001111111100001000101111001111111000100011110011111010001111011011110001110110010110100101010110100000110101010011
100111111011111001001110110011001000111010110000110111010100110111010100101100010100010111001111000010011101001011000011100000100110100110000010011111111111101011001
110000001000001101101010011110011101101010011111100100000101100100011110100001000001110101100101110110110101011010011000111110101100001110110111010001000101001011101
111111011111011001000011001000110101000011000101101101110001110101111000101111111011000100110100010100100101010010111110010010100110111000100100010101010000011010001
100110010101001011010111101101110001011001110101001001010100110100000011100100010010011110010110110001101101010110000111010110101100001111101101110101011111111110101
110010110001101001110110001001100101001100110101011101000110010101011110001101011110110000110110111111001001000011011100010100100110100110001111100100010000100010101
111010100101001100110100111011001101100111100100000001011111110111000110111001001000100110010010000000011011111001110001110001110010110000101000001111111010001000101
100010001101011110000101110011111000110011001111111101001000110001110100100011101011101111011011110111011000001101000111010111011011111010101011111000110011011111101
101111111101000011111100011010000011110110011000001111111010011101000111101111000011000001001001000101001111100100011100010011001001011111111001000010011001110001101
100101011001011110000111011011101110000100110010100010100011001001011110001001111110011101101101101101100100110111110001011010011100000100001101101111000011000100101
110000010011001000101101001000100100111101110110111000001111100011000000111100000000110001000100001001110001110100010101001010110111110101100000101011101001011110101
111011110111100011100001101010110101110100011100101111111100111001111111100111110111111011010111111100000111000101000101111010000000110001111110001000101101010100101
110000000110111111001111101010110001000111000110101100100101101111000101110100011100000001111110010110111100011101111101000010101111100111000111111010100111010101101
100111111100010001011100001010011011011101110000100110001100000110010000000001001101011111000000110000010001110101010101011111101000110010010000110010110110010101001
101101100001000101010001111011010010000000011111110100100001110011011110101111101001110000011011100111110111000101000100000011001010011110111110011010000010110101101
100100110111111101000111101011011011101101000000010001111111011001010011101000101011100111111001110100010100010101010111111000011011001100100011001010101010000100101
110110010000001101111100100010010011001001111111110111010000001101000110001010000010001100101100100001110110110000010010001101010011100101101111101110111111011110111
110111000101101000010001101110110110011011100001000000000101101001110010111010110110111110001110101111000100010101011010101111110110110001100000100100010100001010001
100011101111001111011100000110010000111011001100011111111100111011010110011111100010010111011010100011101111011111001110100001000100011111001101110101110001100011101
111000100011011101000101010011011111101010011111111000001110010000010011000001111111010100010010101001101000010001100100111100011111010000011000010111000111111110001
101110111110010101110111011010010001000010110001000011101011110101011011111100000001000001000110111011001011110100110101100111111000011111111101010000010001100000101
100010110000110000110011110010110100011110011011011010101000000111110010010111110111011111110010010010011001100110011101110000100011001100000111011111110100110111101
101010100111100110011001100110111101110110110001001110001110110100010111000010010011110001100111010110111111001111011001000110101111100101110000011000011110010001101
101110001101001111001100110010001000000100100101101100111000100101000101111000111001100100101100010010100001011101000011101110001001110100110111010011000011010100111
100011111001011000011110011011101111110101101100100110001011111101111100010010001100101110101101111010001011011001111111000011101100010110100011010111101001110110001
110111000011011101000111010010100100000101100110110011100001000101000101010110100110001100100100000011111011001011011000011001111110110100101001110100111100011100101
100001011110001101110100010110110111111100001110111001111011010100010001011111110011100111101111111110001001100001000011111100001000100101111100110110010111000110101
101100010000111001010101110110010010000111111100011100001010010111111111011000011000110001100010100010111100111101011000110111101110001101010110010011010001110010101
101001110111100011000100100000111010110001010101110111101110110000100001000011001101111100111000101000000110011001110011100000100011100001000010111010000100011010101
101111000001110111011110111110101000010101000100010000100100111110001111111111100001100110001110111111010111001100100110001110111000111111011010011010111110110011101
100011011100100100001100100000101111111100010001000101110001100010111100000000111100101111101010001000011101100110111100111010001110100001110011010010110100110110001
101000000111101110111001101111100110000111110111111101011111001010001001111011110110101101000011101011111000110000100001101011011000101100110111010110100101100100111
101111110100001100010011001000110100110000011110001001010110011011100011001000000100001000011111001000110010011011101111000001001101111110010000010110101100001110001
101000011101100111110111011010100101111101000000101100010100110010111111101111011101111010111000011010000111001111001000010101100001000011000111110100101111111011011
101110110001001100000101001010101100001111111111100111000101110110000000101001000101000011100011110011011101100110011110110101101111011001110000010101101000000010011
100110010111111001111101100010001111100000100001110011110001000000111110001101110001011111001011011110000000110100110100010111000100001100011010110100000011111011001
110011010000100011000001111111011000111110110100011000011111111111100011100100011111000000011000000111101111110001100101010001010101111111010011100111111111001001101
111001011110001010011100000101001010000110100111001111000100100000111000110001011001111111011111110001100000011111110001111011011100001000011111001100000101101101101
101101000011111111000111110001101011101100110011101011110101101110000010110101001011100001110000111100111111010000011100110010001111101111000010011111110000100100101
100101011111010110010110011101101111001001111000111000000101101011110110011111100011001100000110001110100001010111001001100110111000100001101010110000111110001110101
101101000000010100110011001001001000011011101110110011111100101000010011001110001110011111111111101010001101010001101011001110001101111100111010011010000111011100001
101001111011000110111001100011011101111010100010100110000110100011011011100100100100110000100000001011111001011101001001011011100100000101110010110011110010011001101
101011000011110100001100111001001100001000101010001111110100111111011000111101110101111011101111111000101011001101011101001010110111010100100110000111011011000011111
100001101110100111111110001101100110101110001010111100000101110000001010011000110100001001101010001101100010011001011111100000110001010110101100111110001001011110001
101101001100001100011010100111110110100011111010100001110100010111111011000010011111101101001000100100001110111011001000111010011101011100101001110100101101111000101
111001100111100001000010110010000000110111000010111011010110110110001110010111001101001001011011110111011000110001100010001111000000010001101101100001100100000011101
110011110000110111111011111000111111111100011110010010000010100100100011111101101001011011011001100001011010010101111111100100011111010111000100001111110111111110001
100110010110011100010000101111100000101001110011010110101000101101111001000001100011010010001101001101001111010111000001110111111001010011010111111100010101010010101
101111010111011001011110001000001110000011011011010111111010100100001101011100111110011000101001011101100001010001010100010000001100011001110101100101110100000110101
101000000011010011010011100010100111111110001000010000001011101111011001000110000011001111101101110100111100011101111110111111100110111101100100001100000101010100101
101111110110010111011001111010111100010000100011110111101010000100010011010011111011100000101000110110001110110100101000100010110011101001001101011001011101111101101
101000010100110001001101000011100001011110111110010100101110110101111011011000100001101110101110010111101010000110100010101010011001100011101001000011001101000001101
100011010101100101100101011110001111001100101000110110100010111101001010001110101111001000100011010001101011110010110110001000111100001110101111111111100101011101001
111110011101001111110100011000111101101001100010000000101000001001011010111000100110011010101000010101001000011010010011111110010111111100100010000100110001001111011
100011001001011000010101010011100001101011001010101110111111111011000010011011110011110011101111110101011101110011011010011011010100000001111000110110011111100001011
101001101011011101010111110111001101001001111111111000011000010011011111001001011000000111001100010100010100100110011011001010010001011101101111110011000000111101001
101111101011001101010000110110011111011100010000010011001101000110000001101101010011111100011001010111110001101110110001100000110111010100000100011001101110000001011
100100001010011001011010010000110000001111010101011011101001111111111101111101000110000111110011010110000100000100100111101111100110010111110111011100101011111111001
101101111000110011001111000111111110111010011101001000111011000010100100011001011100110000011001010010111111101101110011001001111100110101100001010110001000100011011
101001100010100111100001010010001000101010111001101111100010011000001111010011010001100101001111011010010000101001011001101101000001100000001100010011111010101000001
101011001011101101111101110110100011101000110011001100001111011110101100010111010111101101100001010010110110111011001100101000011111001111111111000110000010001111111
100010011001001000001000111100111110001011100110011001111011000100111001110010010010111111101101000110100100000010011110101011110011011100000011110111011111111000101
101110111111011011101110001001100100101010001110110011100010010101110011011011011000100000111001011110101111111111000000101001011010010101111010000010010000110010101
100011110000010010100111100011101101101010100100111000110110110111100111000001111011101010010011001010100000100101110111101101010000110101101011111110110110000110001
111000011101010110110001111110101000100010110110001110010100010000110101011100000001001011000111101010101110110000000100000001000111100100101001100000100011111100111
101111001101110000010101000000100010111110010011100111010101011110100101001111101011011111111110001000111000011011011101011111101100001110101100101111101011000110011
101001100100000111111101101111101111101010111001110001010101111010001100011000111001000110001010111111100011110001000111110000100001011000100110001010101010010011001
100011110111111100010001000001101011000010101100011101010000110011111110110010001101010010101010010000101110000111110011000110111111010011110011111000111010111111101
101001100100001001000111011100001000011110100111011001010111100110000011100111100101111010100011000110100010111100011001011110010001110110111000000010011010100011001
101100101110101011111110010111111110111000110001001011010101001100101000001101110100101010111011111110101011100001001101010011000100110100100011111011001010001001011
101111100100100010001010110000000010001011111101101010010100011101101111111000110110001010001010001000101001101111100001011001111110100101101110000001100010111101001
100000110101111110100010110110101010100001100000101000110001000111101000010010000100111011101010100011101100100010111101011100100010101100100011011111111110101001101
111101110001000100110110011100111011101111001011101111111111110010001011010111111101100010001010111110000110101010001111010110101000100110101110010011000010101011001
100000011111010101110011001001110001100010011000100010101000011011011001110100000101001111011010100000111100101000100000010000101110110010100110111001010110001001101
101101110011010001011011101011011100111010111101111010000011110010011101100101110111011000011010111101110001101111111111110101100011111010110100101100010011101100001
101101000110011111001000100010010110011011110001001011011110000111001001001100110001010011010010000101000111100101000101011100111000001010100101100001111000100111111
100101010000110000011010111111000011001001100101101011001000111101101011011110011100011011011111110111011100110001110001000001101111100010001101101011000010110010011
110101011111111101001110000000010111101101001100001001011011101000001011001011000111110001000101100000010110111100000101011011000110111111111001001110011110111011001
100101010000000101101000111111011100001000011111101101000000001010101001101011010001011111110000111111110010001111111101011000010000110000011101011000111000011001101
101101010110110100101011100011001001111011111000100101111111101110101101001010011101010000111110000010111010100010101001110011111110011011010101110011110011001100001
100111010010010110101011001001111011001111000010101100001000101100111001011000110001000110000011111000000010111000000011000111000011010010000001100110000111100111101
110100011111010010111010011101000011100100011110111001101011101001110011001101100111101111101000011111110110011111111111101110010111000111111111001100101110110011001
100101110001011010110010110100011110110001010010001111001011001011010111100101001100001010101101000000000100110001000000100010110001110100011000011001100000111010011
110101000101011010100110110111111010010111111011100110011000011001000000110101011111101010000111110111111101100101010110110110011100111101001011110011111110101110111
100100011101001000101100000100000011000100100000110100110011111101010110110101001000001000111100011100011001001101010010000111000110000111100001010111000000100100101
110111111001101010100111110111011001101110001010010001110110010101110011100101101010111011110001011001010011011101011011011100011111110001110101000001111101101101101
110000001011001111110000010110001100101011011011111111010111000001000110001101001010010000100101000011000110011001001001110001110000011100100101111101000100000101001
100111011011100000011011010010111110100011010010001100000101101111101100111111011011011110101111111111111111001101111011000111000111001110110100100001010111010101011
101100001000101110111001111000101100110110011110100001111100000110000101101000010001000111100010001100010101100100001010010001011101100010011110111111010110011101001
101111101110111100001100101111100001110100110000111111001111110011010001001010111101110000111011101001010001110111100010110111001001111011000010000010010011111000011
100001000010000101100110100010110111100101100101101011101000011001011011100010001101011110011000000011011011000011001110110011101100101010011011101000111001100011111
111101111011110100110010001000010010001101101111100010001011001101110001111111101000000111001111111110010011011001101000011001001110001011001000101101101100001110111
100001000011010110111011111111011011011100001011001010101011011000011100000100001111110001100000110010110110001100111011001111011011011001111010111000000111111100011
101111011110010010100001000001010010010001111000011000100010001011010111110101111000011011111010000110110100101110011001100100010000001100001010001111110100101001001
101001010000111000101100011111010111010111011010111110111111101110010000110101000011111010000011110010010001100011000011111101110110111111101011101000100101100011101
101100010101101111111001111000010000010100010010010000010001000100111010010101011000100010111110111011011011111001111110000001000010000010001111001010001100001111001
101101110100000001010011000011111101110001010111011011110101110110010011010001001110101110100110101011001110011101011000111111011111110110111100011011111111101000011
100101010110111111000111011010000111011111010100010001100100010011010110011111100010001000110000001001100111000100010010100110001100100010100001110010100011001011001
110100010010000100011100011010110010001000010101110111001111011010010100110001111011111011111101101100110011010001110110110011101001101110101111010110001010011011101
100111111011110101001001001110111000111011110100111100011001001000110101100100001000110010001001100110011001110111000100111010001011000000101001000010111010110001101
110001000000100101101011101000101110001000100110001001000011101110100101001111100011100110101100111111001100011100010101100010111001111111101100011000100010011100111
111011011111101100111001101011101011101110110111011011101110100011110111011000111110001100100110010001100111001110110111001000101011000010000111111111101111000110001
100001011000101110011100111010000000100110100001011011111000111011000110011110000010111001110011000100001101100110110110011111100000011011110000011000100001111111011
101100010010001011000110100010101101110100111111000001010010001010011100110000111010011011011001111111100000110010011100110001001101110000100101001110111100010001011
100111110111101001010010001111100100100101110001010111000111100010110001100111110011010010001101000000111111111011000101100100011000011110101111100010010111000101001
110010010010000011110111111000110110101100010101011100011100111110100111001100010111000111011101011110110000101001110100111111001110110010111000111010110001111101101
111011011011111110100011000010110110100111000101001101110110101000101110011001110001111100000100010010100110001101000110110001100010011000110010110010100100001101001
100000011000100010101001110110100100110011111101111001000110000010100010111100110100110111110111111010101111011101101110100101111111011011100110010110001111101000011
101101001010001000001100000100001101111000000000000011010000101010001000000110000110000000000000000010000001000000001000001100000000010000001111000100100000100011000
111111111111111111111111111111111111111111111111111111111111111111111111111111111111111111111111111111111111111111111111111111111111111111111111111111111111111111111
