1111111111111111111111111111111111111111111111111111111111111111111111111111111111111
0001010000101101000011000000110000001101100000010000000000011000100010000011000011001
1001000110100001011001101010010111100101001011010101111010110010001010101001111000011
1011011100110101001100001011110001110001111011011100001011100111111010111100110010111
1011010101100101100101011010000100100100010001000111101000001100100010001101100110111
1000010100001100111111110000111110111111011101110001001110111001101111011001001100011
1111110111111110001100011011100010000110010001011101100100100011100101001011011101001
1000000100000011100101010000001010110011000111000100111101101000110001101111000111101
1101110111101001110001010101111110011001111101011110011001001101111101000001110010101
1101010011001101011111011111000110111101101100000011000011011001010001101100010110001
1001011010011001000001001000010100010100101001111001111111010011000111001001010100101
1011000010111011101101101110110101000110100011011101001000010110011100011011110101101
1001101110100000001000101100100101111100101001010000011011110110110001001000000101101
1100100100111110111010101001101111000101111100010111111001000100011111111011111100101
1110110001100011101011100011100000010100001111010001100011011101110000011011000110101
1010011111001000101001111110111111110111011000011101001110010001000111001110010000101
1000110000011110101100000010001100010110010011110100011000110111011101101100111111101
1101110111111000101111111000100001010010110111010111110011100000010100100001100010001
1000010110001101101000011110101111111010110000000011010111001111110001111101001110111
1101110011100101100011000100111000101010011111111001010110011010000111001001100000011
1000011000110100110110010001100010000011001100001101010100110000110000011011111111001
1011011110110110011111110111001111111111101001101000010101111111110101110001100001101
1111010000100011001000010001101000001101000011001011110001010000011100000101001011101
1100010111101111100011011111001010101001011111011000111101000101001111111101011011001
1001010001000001111110011000011011100011000001001010011001011101100001000111011001101
1011111101110101001100110011110001001011111011101111110011000111110101010010001100111
1000000100000100011001100111010111011110001010100000011110010100010100011000100110001
1011101111110111110011001100011100011000100010111111001100111101011101111111110011101
1110001110000011000110011001000110110011111000110001100001101001000101010100011111001
1000100100111110010110111011110100100110001111100101110111000011110100000001001000011
1011110101110110110010110010110110001110100100001100010100011111000111111111011011001
1000111100100100011010000110100100111010110001111111011101110001010001000001110011011
1010001110001101110011111110101101100010011111100001000100100101111101101100110110001
1011100011011001000110110010001000111011001100001011110110001101000100101110010011101
1010111000010011011110000110111011110001100101111010010011011101010110001011011001111
1000001111110111000011101100101010100101110101011000111010000101010011101001011100001
1111100001010101111010001101100000001111000100010010001011101101011011001100000111011
1000111101010100100000111001001111101000011111010111011011001001011001011111110110001
1011100000010110001111110011111000101011010010010001110001111011001101110110000000101
1011001111110100111000010111000010111011111000110100000100010001100100100011011111101
1000011010110110010011000100011110001000011111110111111111011101110101101001110001001
1101111000010011110111111110110111101010110001100011000001001100100100001100100101101
1001001011011000010010100000100001101010000100110110011101100110001111111110001100101
1101101011011111011000101110101100001111110110011100110100110011011000000111100110111
1001000001000001001110100110100111111000011111011001110110011001111110110000110110001
1011111101111101100010110010110001010011001000010011000011001100011000111110011100101
1000010000001000110110011110111101000111101010110111101011011111001101101011000111101
1111011111111010110010111000100101101110101010000000001001001101101100100001010001101
1000010000100010011010010011110100001010101110111111111111100100000110101101111100001
1101111010110111001011000110000111111000100100001000001000110111110000100100101111101
1000010010010011101001111111101100001110110111111011100010010001000111110110000000101
1011010111010110101100000010000001111000010001000010111111010101101100010110111110001
1110010100010100100111101000101100110011011100011110001010010100111101011100100011111
1100110111000101110100001010100111100111001111110000111000110110000001011001111000001
1001110001110100010101111110111100001101100000000110011011110111111111010011100011101
1011100100011111000101000100010001011000001111111111110010010001001101011000001110001
1011001101010001101100010111010111001011111000011000010111011100011001001111111011101
1001111111000100100111110001010011101001001011001011000100000111010011100100010001001
1100010001101110110101011101011001001101011001100011111110110011000110110101000100011
1111000100111100100100011001001011011101001101111110101000111001110010010111110111111
1001111110010001101110110011101001011000011101001000100010001100011010110010100100001
1100001111000111101010110111111101001110110001100010101111100111010000111000101111101
1101100101111100100010010011000101101000010111001110101010110011010111101110100000101
1001110101000101111011011001010001001111110100011000100010011001110011000100101010001
1011000000010101001011011100011111011000100101001111111000111100111000010101111011111
1001111111110001101001010111110101000010001101111000011110000110011111110100001110001
1100100011011101001100000010100001111111111000100011000000110011000000110111100110101
1110111000001101011111111010001101000100000010101001111110011111101110010001110000101
1100011110100101010110001011011001010111111110001111000011110000100111011011011010101
1001000010111101000010101001001100010000000111100110011001100110110001001001001111101
1011111010011001011000101101100111011111110000110010111100001110011011101101011000101
1010001011000011111101111000110011011000111110011110010111111011001110001101011010001
1011101001111000001100001110111001110010000111000011010001100001101000101000010011101
1001001100001111101001101000101100100111010001111001010111001100101101111011110111001
1101100111101000101111001011101110110010011100001100010001011101101001000000110110011
1101101100101110000011101001100000011110110111011111111011001001101011010101100100111
1000100001100011011000001100101111001000100010010000000001101011001001011111001110101
1110110101111001111111100110100101101101101000110101111101101000011100001010011100101
1010000100001101000000101110110001001001111110100100100001001111110101101010110001101
1011111111101100011110111000111111011100001100101110101101011000000111000010010111001
1000000000100111110010001011100011010110100111101100100111011110110001111111010001011
1011011111101100000111100010001010010010110001000101101100001100111100010000011101001
1011110001000101110001111111011000111000111011011101111001100001100111000111110101101
1000000100010001000100000000010010100010001000000100000011110100110000010100000000000
1111111111111111111111111111111111111111111111111111111111111111111111111111111111111
