1111111111
0010100001
1000111101
1110001001
1010100011
1011111001
1001011101
1100010001
1001000100
1111111111
