111111111111111111111111111111111111111111111111111111111111111111111111111111111111111111111111111111111
001000001000000000001010001101010010000100010001000000101000000001000101010110001100001101100010000001001
101011100011011011011000100001000110110001000100011110101011011101110000000100100110100101001011011101101
101000101110010001110011110111010110111011111111111000100001000101100111110001110110110000011000010100101
101111100010110111000110000110010010011010000010001011101111110101001101011111000100011111111111110110101
101000111010110010011111011100111011010010101000101011001100110100011100001101010101110000001000010000001
100010001110100110110000001001101010010111101111101001101001100111110001100001011101011011011011000111111
111111011000101100010111111011001000110011001001001100100011001100011011110101001001001011110011111100011
100001001010111001010000011011101111111001011011011110111110011001110001100111100011100000110110000101001
101111101011100011010101000000100001111101010010000110000010111100000100101110111110101110100100110001101
101000001000001011111111101110101100110101011010110011111010000111111111100000010000100100101101100111101
101011111011011110001000111000001001100001011000011010011011110001000001111011110101110101100111001100001
101011001110001100100010001110111111001111001011111011001000011101011100010000000100100101110100011001011
101001100011111001111111100011100010011011101010001001101111000001001111011101010110101100000101110011001
101100101000110011001101111001101011010010001110101100101001111111100001000111110010100111111100011111101
101110001110010111100100001101001000011000101100100110001011100000101101110000011110110011001101010001111
101011111011000101110001100101011111111110101001110011100000001111100100111110110000011000011001000100001
100000101011111100111111001100011000001100101011011001110111111000110110100010010110111110110011111111101
101101100000010110100001011111110011100001101010011100011100000010010010001011000100011010011000010000101
100100101101010000001100011000011010111111001011010111011001111111011011111011011111001011001101110110101
110111101001011011111111110011000000010001011010000010010011000001000000011010010001100001101111000100101
100010001011000001000001100110011111010111001000111010110110011101111111010011110101111111101000011110101
110110111001111111011101001111111000010100011111110010000111001000100011010111000100001000001011111010001
100000011011000100000101011000001011110101110000010111111101101010101001110100011111100011111000001011101
101111110010010001111100010010101011000100000101110100010100001011101101000101010000111110010011101000101
100001000110111111000111110111101001010111101111000101010101101010001101101101111010010011000110001110001
101111010110001100010001000011001100010000100000011101000100101110111001000100101011010111111111011100111
111000010011100101111100011110011111111101111111110001110110100110110011010110000010000110001100010101101
100011011000110100001111111000110000011000110101010100011100110100100110011111111111101100100001110100101
101111111111110110100010110011100111110011100001000101000001100101101111000100001000100001111111000110001
101000100001010011111010011000110000100110001101011111011111101101000001101101100011111111101001011111101
100010101100011001010011001110011010101110111001110001110000101101111101100000111000000000000011000110001
111110101111010011000111100111001010000000101011100100010110001001000100111110101111111101101110010000111
110000100011010110011101110001101111111111101000001111000011101011010110001000001100010001100100111111101
100110111001000110110001000100100011000010101101111101111110001001010011101111111001010111001101110001001
101110101101111100100101110101111010011000100001000100000000101100011011000001100011000100011001000100011
101000001000011001101100010100011010111101101111010111011111111111111001111100001111011101001011101111011
101111111010110011001111011110110010011000001001010001001100011100001100100111111101001111101010001001001
100100001011100110011001010000110111001111111101011101011001001001100110110010000001101000101000111011101
110101100001001100110011010110100101100110000001010001001101100011101100011000111111001010111111110000001
100100111111011001100110010011101101110100111011011011100100111111000111011110000100011010000000011011111
110110001011010011110100110111001000100101100011001001110110000001010001001100110001110011111011110010101
100111101010011000110001100100011010101111001001101100100111010101011101100111110111000110101001100110001
101101101010111110100111001101110010001010011111101110110011111101000100110100010110011110001100101111011
101001000010001100101100011101100111111000110000001000011000000111110110010001010010110010100110001000001
100011010111101001101101001001001101011101110111111111011111110010000011011111010110111000101111111011111
110110011100001011101001011011100001010001010010000100010000011010101110000110010100101101100100010000011
100011010001111000100011001010111100000101011010110110111011000010100011101100110101100001110001011011001
101010010111011010111111011010000111110100011000010100001011011110101010001001100101101011011111001111101
101110110110000010010100010010110000011111001111110101101110001011101011111011111100101011000001100010001
100000100100111011010001010110111111001101101000010111000100100001111001000010001110111001101101111000101
101111101101110001010111110010100001100000101110110001110101111100011101011010100010001100100100001101101
101000001111100101011100011010001100111010100100111101000111000111001101011010111011100110110101100100111
101010101000111101000101001011111110110010110001100101110001010011100101001010011001110100100111101110011
111010111010001001110001101001001000010110011101001100011100011010110001101011001011000110111100000011001
100010110010101100010111101101100011110111010101011111010111110010011111001011101000011100100001101111011
110111100110100110111110000100111011010100000101001001010000010111011000011010101111110001110101000100001
100001001111110010100000101110001000010111101101100011011101010101010011110000101010100111110101111101111
101101011011011011101111100011101101010110001000001010010001110100000110000110101000001101100111000001001
101101010010010010001000111000100111010010111011101110110111100111011111011111101110111000001100011111101
100111011000110110111010101110110110011011100001111000100110001100010010000100001000101110111001111010101
110010000011100100100010100000010100110010001011000011110100111001111000111101111101100100110011100000101
111000101011001101111110001111110110111000111110011010010101101100001111100001010100110001100110101110101
101111111110011000000111011100000100011111100110110011000101001110100100001111000001111011101110001000101
100000000110110011110001111001111101001000101100111111101101100000101101111101101111100011000011011011101
101101010000100110011100101100001111101110001001100011000100101101111001000001101010101001111010011010101
101001111111101111000110000110100010100011011011001001101110111001000011101011001010001100011010110000001
101011100001100011010011110000111010111000001000011101001000100011011110101000011010111111001010011111101
101010001100111010011001011111100010000010101110110001011011101001010000001110110000100011100011000010001
101011011110011011001100011000110111111111111100010111010010101101010111111100110111101001111111111011011
101001010011001001011101110010010101000100011001010100000110001111011100001001100100001011010000010001111
111101000111101101110001000111010001010001001011110111011100100011000110100011001101101000010111010100101
100001010000111000000111011100011101011111101110000110000101111001110010111111101111001111010011011110001
101111110110100011011100001110110001001001100010111100110101001100011000100001001000011000011010001111011
100000010111101111110001111000100111101100111010011001110101101101111111111011011110110011111011100101001
111111010000101001100111100011101110000110000011001111010100100100001000000001000010110110001010110001101
100010011010000011001100001110100011110010101111100011000110110110101101101011111010100000101010111101101
101000110010101111011101101000111000111011101011001001101110110010100101111110000010111111100010000000001
101111100110111000010100111110001110001001000010011101001100010110110101000010111110100000101111111111101
101000111111100010110110010000101011101101111011111001011001010010010100010110001000101110000110000110001
101010000001101111100111011101100000100001000010000011001011000111010111110011101011100110110100110100111
101011110100101001001101001000110111111111011110111111101111110001010000010110101001001100011101110110101
101010011110101100011001101110100010000001001100100000100011000111011111010110101101111001110001010010001
100011001010001001001011000100101010111101011001110110111001111100010001010010101000110011011011011011011
110111100011111011101001110110111110100100010011000011101100011001111011011000101110011000010000001010001
100001110110000011001011010010011000001101110111011001000111000011010001001101100111001111110111111010111
111011000010111010011010011011000011111000010101011011010001111110000101100101110101101000010110001010001
100010011010001110110000111001111110001011010100001110011100101100111101110101000100001011010010100011101
110110111000100010011011101101000000101111010101100000110110000001101101000001011101111011011010111110101
100011110010111011011000000100011111100110000101111111100011111111000100011111000100010001000010011000101
111001100110110010001101010111110000110011111101000000001001101010010111110011110111010111111111010010001
101100101111100111100111011100000110111001001000010111111100100011110000011010010001000001100001011010111
100110111100001100110011000111011110101101100010110100010110001000100101000010111101011011001101001110101
101110110001111110011001010010010000101100111110011101000110111010001101101000110001011010011001100110101
100010100111000011001101011010110110100110000011001101101100011111111000111110011011110010110011110100001
101010001110011001101001001000010010110011111001111000100111010000011010100011001000011011111000010111101
101111111010111100100011101111111010011000001100010011110001010111001111101011111111001001100010110010001
100110110010101001101110001100010011000011101110110110011101010101100110001000000001101100111010011011111
110010100110001011001011100101011001111111001010110000110001010001110011011111111100101110000011111000001
111000001111101011011011001101001100000101011010011110011011111100011000010000001001100111111110001010101
101101100110001001001010011001100101110101000011000011001001000111011111110111011011110010000100101111101
100000111100111101100011111011110111000101111011110111101101010001010000111100011011111011010101101100001
101110010001110100111010001010100010011101100010010010000101011100010101101001001001100001010101000101011
100011000100000110000000100010001000110000001000111000110100000101000100000011101100001100010001010001000
111111111111111111111111111111111111111111111111111111111111111111111111111111111111111111111111111111111
