1111111111111111111111111
0000000011000110001000011
1011111010010010100011001
1111000011011010110111101
1000011110011000010100101
1011111011110011110110101
1010000000100111010010101
1011101110110110011010101
1001001000100000110010101
1100011011110101100110101
1001111010010111001100001
1011010011010010011110111
1110010110011010110100001
1100110010110010000111111
1001111010011011110010001
1011000011010000111000101
1000011110000110001111101
1011110011101111111000101
1000011001000101000010101
1110111100011100011110101
1010010001000101110010101
1011011111010101000110101
1010000001111101101110101
1000110100000001000000000
1111111111111111111111111
