1111111111111111111111111111111111111111111111111111111111111111111111111111111111111111111111111111111111111111111111111111111111111111111111111
0000110000000001100001100011100000010011010101010110101001000000001001000000101100011000101000010100000000011000010100000010001010001101000011101
1010100111101100110111001001001111011000000000010000001011011010101100011110101001010010000011000111110111001011000101111010100000100100011001001
1110111100001110110110011100011000001110111111011101100001001110101001110010100011000110101110010000010011100011110001000010111101110110111100011
1010001101111010010100110111001111100010100001001000110111011000100011000110111111111100100110111111011000111110011111011110100101000110101001001
1011100001000011000111100011011000111000110101101010011100001011111110010010000100001111110011110001011101101000110001001100110101110010001111101
1000110111010111110011001010010010001111100111001011000001111011000000111011110001100001011001100100010000000010111101101001100100011010100001101
1010011100011100011000011010110111101000110010011001101111001001011111101010111011111100001101001111111111111110001000100011001111010010111101001
1011001001001001001111110010100011001010111000111111001000011101000010001000011110000111100001011100000110000111101011111111011000010111110001011
1001100011011011011000100110101110011011101011100001011111010101101000111011001100110000111111000110110010110101100011000101011101110001100111001
1100110111110001000011101110100110110000001001101101000100010100111110011001100101110110101001110100011010100100110110010100010001011100001101101
1110010011000111110110001000110010011110111100101001110001010110011011001100110100010110001011000101010000110110000000110111010111000111111000001
1011010110010100010100111101100111001100110110001011011111010111001001100111110111010011100011011111011111100100111110100010010001110010101011111
1011010000111101010101100001110001100101100011111010010110000101101011110100000101011001101110010000010010110101110011111000110100011000100010001
1000011111111001010001001100100111110101001000011011000000110001001001000101110001011101000100111110111000100100000110001111110110110010101110101
1011110000010011011111011110001100000100011010110010010101111111011100011101011101000101111101101000100010101111101100100100011100100110100000101
1001011011010111000001110111111001111110111111100111011111010000001111110001000001101100001001100011111110000000101001110001001001110100111111101
1101000010010100010100100101000011010100010001101110010000000111111000111011111100100111011011001001000110111110101011011111101101000101100000101
1101101111011101111110110000011111000101000101001000110111111100001010001000000111110001011011101100010011100010111010000011001101011101001101101
1000100110001001101000000111110001010001010101011011100101000101101011101111110000010111001000100111111010001010010011011001100001000100011000101
1110110011100011001011111110000101011111110100001111001100010001001001101000011111000011101110101100001010111011000110001100111111110111110011101
1010111000111110011010000100101100001000111101100000011111111011011101001101000011101110101100111001101010001011111100111111100000110100111001001
1010001110000011001010110111100110111010001111111111110001000010010001011001111000100010100101100011001011101000000110011010001111100101100011011
1011100110101001100010010000111100100010100000101101000100010110110111011101001110111000110101110110011000001011101111001010100100001101101110001
1001110011101100110110111010000101101111111110100000010101111100100101000001101010001111110100000100110011111111000001100000110001111001001000111
1101011000100110010010001111110111000001010000110101111111000101101101111111100011100100000111111110011000100001011111101111111011001101011011101
1000001110111111011011100100010011011111000111100111000011010100001000100011001000110001110011000011001110101100001000111000010001100001001010001
1101111000110000001110110001111000010100010100001100011000010111111011101001101110011111011001101111100011100110101010001011011100110111011000101
1000001011100110101000011100101111110101111110100110111111110101000010001100111000110100001100100110111000110111111011100001001110000100001111101
1101100010001100111011000110100110000101000010110010100011000101011010111110000010000001100110110000101110010001010000111111100011010101100010101
1001111110101101110011010010110100101100011010011110001010010101011000100011101111011111111100011010100111011100000110011000111011110101111110001
1011000010111001100110011010000101100101010011000011111010111100001010001000100001110000110001110010110101001101111110110010010001100100000010111
1011011000001111001100111111110111001111110110011010001010001001111111111101111100100110010111000110000001100100100011100111011101001111110110001
1001001111101000011110001000010100011000000100111000111011101011000001100000001101101111000100011111110100110111101010001101001101011000110111011
1101100001100011111000111011010110111110111101110010010000101010011100111111100100001001111101001000011110010000001010111001100001010010100100001
1001111100111110001010011001000100110000100001100111010111101110110110010000111101111011010111101101001100111111111010101100111111000110101101111
1011000110110100100011001101111110100111101111001111110101100100100010110110000101100001000110001001101001100000001000100110001001111100101001001
1010010110010101101001100100001010101101100010011010100100101101111010000011110100001101010000111111000011111110101111110010100011101101101011101
1010110011000101101100111111100010101000111010110010001110101001000011111110000111111101011101100001101110000110111000011000110110001000100010001
1010011001110100111101100010111000101010001010011010111000101011011001000011011100010000010000101100100010110010000010110011110000101011111111101
1011001111100110000111001000001110101111101011000010001011101010010011011010010001011011111111101110111000111011011110010110011011101011010000001
1001100110001111110000011010100100100101001001101111100010001000111001011000110111010010000110001010011110100001011011010011001001001000011011101
1011110100111000011111111111110001110001011101101100001010101111101101001111100101011010110000111011000111111101001001011000011101011111001000111
1001000101100011000000001000011011011101010100100101111110101000001001100011001101001110111111100011110100011001101011011111010101110011101110001
1101101101001001010110111011001000011001000110110000001000111011100011111001011001100110100010001000100101001100001000001001000100100110100011011
1001001001011101110011100011101011110011010010011110111010011001111110001100010011110000001011011111101101100110111111100011110110001100101001001
1011011011000111000111001110101110000111111011011011100010110011010000101111110111010111111000001000101000110011100011001000010011101001111100011
1011000010011100010110011000000100111110000001000001001110100110000111100001100010011100011111111010101011111001101001111110111010000011011110111
1001101110110001110010110011110001100011101011111101011000101100111101111011001000110001010000000010101000101100001101100010011010111011001100011
1100100111100111000110100111011111101001001110001101010011100001100000001001101101110111000111111110001110100111111000101011010010100001100111001
1110110010001101011100101110000000001101011000100001010110111111111110101100111001100101111110000000100110101100001110001001110110110100110001011
1010011000101000000101101100111111111001010011111111010110010000000011100110000011001100100000111111101100100001100011111100000010011110111101001
1011001111101111111100111001100010001011010110010001010100110101101000001110111001011110101101100000111001101100111000001111111111000110000101101
1001100001001000011001110011001000101000010010110101010001110100111010101010011111010110100111001110000011101111100011100001000011110011110101101
1011111101011011000011100110011111101111111000100100011100100110001111101011010001000010110011011011111110001000111110001111011010011000110001001
1010000101111011111110001100110000100110001011101111001101101111100101000011010101011010111010010000110000111010001100111000011000111110011111011
1010101100100010000000100110100110110000100001100101100111001000110001111110010101110010001010110110100110000011100111100011110010011011000110001
1010100110001110111110111100110010011111110100110101001100011010011100110000110100000110101010000100101100111110110100001111010111001001110000111
1000110111111100010010110001111011111000010111100101011001010011010110100101100111111100100011111101111001110100100101111010010001100011011111101
1111110000011001011000010111000010000011011100001100010011011111000010001101001100110001111111010000110011010001101101000010111100111001010000001
1000011011110011001111110100011010111110001101111001110110000000011111111111011110100111000001010111100110000101100101101000110110011101000111011
1011001010000111101000010101111010000111100100011011000111111111110000110001001010001110011100010100110011101100110001001110010011001111011100001
1011100010111100100011000100100010110000110111010010011100001000000110010101100010111100110110110110011000101110011111100011010111100100001110101
1010111010011001111111111110111111111101110110011110111001100011011111010101101010010110110010010011001110101011010001110111000110110101100110101
1010000011001100000000010000100011000100010000111000101011111111110001000100111010110000000111011011100010001010010100000001110010100100111100101
1011111111100111101011010111101001010101011011100011101001000001100101111110010011100111111100001001101111111010111101111100110110001110100001101
1001000011110001001011010000101100010101001010001110001101101101001111010011011001001110000110101100100000100010001100110110011100101000101111101
1100011001011101011010011101100111110111101010101000100100100100011100000111001101011000110000101110101110001111100110010011001001101011101000001
1101111100000001011010111000110110000011001110111010111110110111111001010001100101001011111111100110100111011000110011000111101011111000101111101
1001000111111111110010101011100011111001100010010010000100100000110011011111110101101000110000110010110001000010011001110010101001100011101000101
1011010001000100000110101000111000001100110111011110101101101110000110000011010000101110000101111010011101111110111100111010001100001110001010111
1011010100010001111100101010011101011110010101000011101101000011111111111001010110101011111100001010110000001000110110001010111111111100111010011
1001110101110111100001100011000111010111000101111001101001110110000010001100000011101000000111101010100111111010010011101110110000000101110011001
1100111100010100110111111111101100010001110000001100101011100011110110101111111110001011111100101110110000110011011000100010000111110100010111101
1110001111010110100000010000101101110100111111111110101010001000010000100000001100111010001101100010011111100111001101111011010100000111000010101
1111101000010110001101000110001001100110011000011000001011111111011110111101111001100010100101111011010001001101101000001001110101010011111110001
1100101110110010111111111111011011001111000011010011111000000001000010000100100011001000110100001001010101011000000011101100110101110110011010111
1001101100011011100011000101010001011011111110010110011111111101011011111110101110011111110101101101000101001111111111000110011101100011000010001
1011001001001000001001110100010101011001000100110111010000000101110000001000100110110001010000101101101101100011000000010111001001001001110111011
1000011111011111111100110001110111001100010101100100000111110100010111101110110100111100011111100100111001101001011111110001101101011100110101011
1011110001010000101110010100010011101110110100101110101100100111011101000000010101100001010101110110010011001101110000011111001001110110000001001
1001000101000110101011011101111000100000110110100011100110101101000101011010110101111011010001000111000111011100100111000110011011100011010101101
1101101101111110001001001000101110111111100100111000110010101101110100001111100101010010000101011101111110010110101101010100110010001010011111101
1000001101000011101101101111100010001101001101101110111000100000110111100110001100000111111101011000100011010010001001110101111010111110110000101
1111111001111001001000101000101011100101011100101000011110110110010000110010111111110100001101000010001110011011111101000100110010110000100110001
1100010011000011011110100010001000110100010101100011000011100011011101111010001000110110101001101111101100110001101001010110010110100101101111101
1001010111101110010100101111111110010001110101101111111000111010001101011111101110011100101011101000111001110100000011011111010100001100100001001
1011110110000100110001111000000011011111000100000010001110001011101001000110100011001001101000100010100011000110111001000110010111111110111101011
1000010011010101111100010011110111000011101111111110100011100010001011010000111001101011001110111110101111111100101101110100110000010010010101111
1111011001110101000111010110110101111000000100001000101001111110111000011011101101001001011100010000100101000101101000010101110111010111010100001
1000001101000100010110010100010000011101101101100011111101000010001111110010001001011011000111010110110000010001100011110100010011010101010111101
1011101001101111110010110101011011000111001001111110010100011011111000000110100011010001110011010011111111111111001110100111010110010001000010001
1000111011100000011010010101011010010100011011000111000111110000100011110100111110010111011010011001000110101000011010101101011100111011111010111
1010000010101101111011010111010010111101110011010010010000011110001111000101110000110100001000111100010000101011110000101000010001100000110010001
1011111110100100110010000100010110001001100110011010110111000111111100011100011110010001011111110110111110001010111101100011110111111110100111101
1001000000110110011011010001010110111011001100110000010100010100000110110111000110111111010000000010100011011010000000111010000100001000101100001
1101101110010011001001111111110100100010011101111111110101111101110000110001110010000010000111111110101010010010110110001111011110101010100101101
1000111000111001101100100000100110101110111000011010000100011000111111100100111011111000101100010000101000110110010010100101001000101010110100101
1110110011100011100110001110101100100110001011000010111101110011100000001110001000001101101001000111101111100100111011110001101011101010100110111
1010010110001110001111111100001111110010101111101010100001000110001011100111101111100111111011111101000110101101101011011101001001000010101110011
1011010110111000111000010001111000111011100010111010111111011111101001111100000010110011000010011000011100100100001001010100011101011111101011001
1010010000110010010011000100100010001001111000110010100001000101001100000111111000111010010111000010110001110111011101000111111001001000000001101
1000111011100111010111111101101111101100001101100110001011110001011111110110001011101010110001110111110100010001010001010000001101101011111111001
1011100001001101110001000111001000100110100100110111111000011101000000100100101001001011110100100101100111111101110111010110101100111010011000011
1001101111011000011100010010011101110010101110010000101101000001111110101101101100011001100110101100001100000101000100011100100110001010110011001
1100101001001011000111011110110000011000100011011010000111110100000100101101101111011100101100100111011001110101101101110001110011011000110111101
1110101101100001101100001000100111111111101110001011111100011111110111101001001011010110100110110000011011010000101000100111011001001101100010111
1000100100111111000101111011101110000010000111101011000101010000010110001011011000000010110010011101110001011110001010101101001101100101001110001
1110110101110001110101101011000000101000110010001110010001000111010100101001011010111010011011000111000100000111111011101000011000110101011000101
1100100100010100110101001001101111101111111110111000111011111110010001101101001110011111010001110010011111111100001001001010110010000101011011101
1001101101110110010000011100111000100100000110010011101110000010111101001001100111001101011100011000110001000101011101011010100111111101000011001
1101101000100111011101001110110010101101110011010111000110111000101001111011110011100001000111111111100100010111000101011110001100010001111110011
1001000011101101000101100110000110100100011000010001010010011111100011000010111001111101110010000000110111110001101101000011101001000111000010111
1011111111001001110100110010110110110111001111111101111011000011001110011110101100100000011011011110100100111100100101011000101011111100011010001
1001000000011100110110011111100010100101101000010101100011111010011000110000000110111111110010011000001110000110110101111110111010101101011011101
1101010111111001100100110001001110101100101011000001001110000010111011111111010010110000010111001111111111010010010100100010001000100001001000101
1000011100000011001111100101011100100110101001101111011100101111110000100001010110100110110111100010000110010111010110101011011110111101101101101
1111111001011110011010001101110001110000101100111000011001101000011110001100010100101110010010111010110000111100010010101011000100000111001000101
1000101011001100110000111100100111011110101110010011001011001011000111100111111101101011011000100010011111111001111000101001110001010011011010101
1010001001100001111101100110001100001010101011010111101001011001010010110010000100000001001110101111010000010011101111101100100111111000010011101
1011011101111111100000110011111001111000100011011100001101111011111000010110110111110101011010001010010111000110000011000110101110001101110110001
1001000101000100001111100110101011000011101001000101100100101001101111000100100000010111000011111000110001111110111010011100111000101000110111011
1011110001110001111000001100001010011110101101110100110110001100100001111101111111011110011000001101111101000000100010110110011011101110011100001
1001011111100111101011100101100010111000101101100101111111011110001100110001000100010000111111100001100100011111101110110011001000100100110001011
1101010110001100100001110001111110110010100101001101000001001011101001100111010001110110100000111100110111110000101100011001101010110101100111001
1000010100111110101100010111000000100111110111011001011101100011001111001101011111010111110110001110100000111010100111001100101110110100101101101
1111000001100000100111011100010111101100010011011100010000110110011100011101000110010000011111011000101110010010110011100110100100100111101001001
1001111111001101110001000101110110001101011001000111110110100100110001110101110010110111001010010011100111010111111001110100110001101100001101011
1101100011011000000101010100011100111001011101101100010011101101100111100000011010010101100011000110110100010100011101010101111111000110111001001
1100001001111111111111110111001001100011001000100101011000100000110100110101110011000001111001011110000101110101000001000100000101110010100011101
1001011100011000001100000001100011001111101110110001001101111111100101100100011001010101001101000011011100100101111111101101011100011000110110001
1011001111010010100001111111111011011000000000111111100101001000001100001111001101111100011101111010010110001101100000001001001001001111100010111
1001100010000111111011000010100010001111111110001101110001011010101001011011101100000111010100100000110000101001001111101011111011101000111010001
1011111010111110001010011000001110111000001011100100011101011011111011011000100111110010000110110110011111111011011000111000000010001010000010111
1001001010001010101110111111111010011011101000110111011001001000001110001101110010111011110010010111110000000010010010010011111110100010101010011
1100011011011000100000110000110011001010101110110100010011101111100100100000010110000000011111010011000111111110110111010110000000111110111111001
1111001001001011111111100110010111100010100010000001010110000101110111111111010000111111000000011010011100001000110100010010111111101100010001101
1100011101011000110001001111000000111110101011111111010100111100010011000011011101100011011111110010111001100011100101111010010101001001110101001
1001110101001101100101100001111010000000111000110001110101100001011010011001010111001001010000100110001100111110111100101011010100011011100101011
1101100101111100001100111100001111111010011110000100000100001111001000111101000100011101110110101111100110100100000110001010010001000010101100001
1000110101000111111110000110100100000010110011111111111101011000011111110101101101110001100100100000110000110001010011011010111011111110001111111
1110110101010000100011110111110101111010011000010000100001110011001000010100111000100101001101111111111111100111011000001010110010000110111000001
1100010100011101101000100000011101011011001011000110111111000111100011010110010010101111011100001000000110001101001111111010011110110010100011101
1001000101000100001010001101000001000001100010010100000000010100001010000011000110100000000101100010110000100001100000000011000000011000001010000
1111111111111111111111111111111111111111111111111111111111111111111111111111111111111111111111111111111111111111111111111111111111111111111111111
