1111111111111111111111111
0001000010000000100001101
1001011000110110001011001
1011111111100011111000011
1000101100001011011111011
1110001001111110010001001
1011100011000100110101101
1000111111010001110100001
1011100001011011000111111
1000110100001001011100011
1101100111101011001001001
1101101101101011100011101
1001001000111010111110001
1011011010011000010100111
1010010011001011010101101
1010110111101001000100001
1010011100001101101111101
1011001001111001001010101
1001101011000011011010001
1011100010010110001010111
1000111010111100100010101
1010001010000111111010001
1011101011110010001111011
1000100000011000100000000
1111111111111111111111111
