11111111111111111111111111111111111111111111111111111111111111111111111111111111111111111111111111111111111111111111111111111111111111111111
00001000000011001000000001000001111000010000011000010001100011000011001000100001100001010110000011000001001010100010000100001100100001001011
10100011111001100010110111011100110011010111010011000100001001111001011010101100101100000000101001010101100010001011010001100110001101100001
11101110001101111011100110000110100111010110010110010111111100011101000010000110000101011011111101110100001011011001111011110100111001001101
10111010111100001010001100111100001100010100110010111100010111010000011111110010110111110011010100100111111010011100000010000110001011011001
10010010000111101010111101101001111001110101111010000101110000010111000000011111110011000110000110101101101011000111111110111111101001111101
11000110110000101010000001001011001011100101101010110101000111110001111101111000011110011110110010101000100010010011001000100010001100100001
10010010011110101011111111101001100000001100001110100101011110011111000100100011011000110000011010001010001110111001100011101010111110101101
10111010110010001000010110001100101101100111100011101100010011000000010110101111001011111011111011111011111000111101001010001000100110111101
10011010000111111111010000100110111000111110001000001001110110011011110010100101100010101000001111000010100010011001011011101111101100100001
11010011110100000010010111101100011111100011011111111011000110111010011010110100111110001111100001011110101111110011001111001100000101110101
10010110010001111011010100101101000001101001001100011001010010001010110011110101110100100000110101000100101100000111100110011001010100010101
11010000111111001010010001100111111100001101111001001101111000111010100111000100000110111110110111110110000101111110110000110011010111010111
10010101100001011010111111110010110111111100010011100100001111100010101100011110110100101010000110010011011100001100111111100110010000010001
11011100001100010010010000111000000100000111010111001111100001001110001001110010110110100011110100111001111001100101100011001100110111111011
10001111100111110111011010001011010101110000010001101000111100011000111100011000010000101000110101111100001111110000101000011001110100010011
10111000110011000101011011101111010100011111010100111010001111111101101001001111011111111010000001111111100001100110101111111011010101011001
10001110111001011101010010000110010111000001111110010011100110001001000011101000010000011111111100111000111100111100111100001110000001011101
11100010001100010000010111110010110101111101000111000110110010100011111110001011010111001100001110010010000110000110000001100011111111001001
10111010101111110111110001011000100100000100010001011100011010111111100000111011110001101001100111110110110011110100111111110110000011101101
10110010100010110011000101011111110101101111111101011001001010110001001111100000011011000011110000110010111000010101100000010110111010100001
10010111101000011001111101001000010100100000110001001101011010011100011000110110110001111110011110011010001111110100001111110000100010111011
11010001001011001100001001100011010110111110010111101101110011001110111010100100110111011000110011010011101000100110101100011111101110001001
10011101111001101111100011001001110010100011010100000101100111100100110011101101100100010010011001000110101010001110111001010000001000111011
10110100011101100001111111101100111010001110010111110001001100110001100110001001001101010111000011111100100011111000110011011011111010110001
10010101001000101011000000111110001011011100110000110111011001111111101110111011011001110011101001100110111111001010100111001010000010010111
11000111101111111011010110000011101011110001111110100011000011010000000010101010001100000110101100001110001101011011101101100011101111110101
10010011000001010010010011111000101001100101000110101110011011000111010110001010111001111100100111111100100100010001101000111111001000000001
10111001111101000110111010001110001100001101101100111000110001011100010010111010001101100001110001000001110001000101001101101000011011111101
10011100001001101110101010100111100111111100001001110011100101000101111110100011100100110101011100011111111101011111011000001011001001000111
10110111011011000000101000110100110100000110111011000111001111110100101000101000110110000100000101111010101001111000011101100011011101010011
10100001000001101111101111100110000110110010011001101100011100000110100011101110010011111111111100000010001011000011110100111110001001011001
10101011111111000100000001001100111110011011001101000101110001111100101110100010111000001010001110111110101110011110000110000111101011111101
10001010000001110111011011011101100010110001101001010111000111000110101000111011101111100000101010011000100110110000110111110001101000100001
11111011011101010010011001010100001000100111001011010001011110010100100010101011000100111111101000110011110000011011100100011101001110111011
10101010010001011011110011010110101011111100011001011100010000110101111010001000010101100011001111100110011111110010001101010001011100100001
10001011010111001010000110010100111110000001011101000101010111100100001111011110110000101001101000001100110000000110111001011011110101101011
10101001010101100000110110110001100000101011110101111111110001101101100100010010111111101100101011111110000111111100001011011000000101101001
10111101010000101111110100110111110111111001100100000011100111001000111101111010000000100110100011001100101101000111101010001111010100001101
10110001011110101000011101100010100010001100001111111001001100011101100001001011111101110110111110011001101000010001100010100001010111111001
10010111010110101011001001001110001110101110100010001100011001110101101111100010000101000010011000110011001101110100111111111101010000001011
11000100010000111011101011011000111100100011111011100101111011000000101101001000110101011011000011100111100101000110110001000101111011101011
11011110110111100010001001111011100001111001010000110111100001111110100100011011100100011111101110001111110101110111100100010100000010001001
10010000100100001111011100000000110111011101000110000100001111100000110101001000111111110001000100111111010100100010001111010111111110111101
10111011101110111001010111011101100100000101110110111101101001001010010111011101110001000101101101100110000110101010111001011101001100010001
10101001100000100011000001110001001111110100011100100001101100011111110010001000010100011101100001001100111110111010110011001000011001110111
10001100111111101001111100011111011000010111011001101111000110110000111011111010110111110001001111101101100010001010011001011010110011000101
11101110010001001100000111011000010011010101001011100001111110010110100011000010010000011011011000000100101010101111001101011010110110011101
11000111010111011111110000010011111011010001101010111011000011010010101110011111011111001010011101010110001011100101100001000010010100110101
10011100010010010001011111110111000001011011101000001000011001011010000000110010000101101011000111010011111001110000111011111111000101100001
10110101110110110100001000000110010101000010001111101111111101000010111111111000110001001001110011010110001100111011110001000110011101111011
10110000110110010111100011111100111101111110111000101000101001011111110001000010110111011100011001110000101110001001100111010010110100100011
10011010010011010110001111000110001100011000100010111010000011010110000101111110011100001111001100011011101011101100001100011010110110101001
11001111011011010100111010010011100111000011101010010011111110000100101101000011110001111001101111001110001000100111011101111010000100101101
11100110001000010101100000111001110001111111001111010110000011111101111001011001100111000011001001100110101010101110001001001011110101101111
10110011101101110101110101101101011011000001101100000100111010000001011011001101001101101001011011110000101010100011101011101000011101000001
10111000001001010100010100101100001000011101100111111101101000101011001000011101011000101101010000111110100011111010101000101111000101111011
10001111111011000111010110100110111111110100110010000001101111111011101111110001001110000111010111100000110111000010001110000001110001000001
11011100001001111110010100110000010100000110111000111111000110001000001001100111100010110000010000001111111100011110111011111100111111011011
10000001111101000000110101111111000111101110101011100000010010101111100011001100001011111110110111101000100001110010010000000110001010010001
11011111000001101111110100001100010011000010100010001111111010101001111001011111111010000100010000111010101111000111011111110011100000110111
11000110011111101011000101101001111000011010110110100010001110101100001011011000001010110111011110100010001000010001000011000110111111110001
10010010110100001001011111101011001111111110100011110110101100100110101001010011101010100100000111101111101011010101111010010010001000010101
11011010010001011101001100001000011100011100111011000100100101110100100011010110000010101101110011001000111111010111000010110110100010111101
10001011011101001100011001111010110001001001100001011101110101010101111110010100111110100111100110011010011100010010011110010010111110111001
10111001000111011001110011011011100111100011001100010001010001000101000000110101101000110011001100110011001001011010110111011110101010010011
10101011110100010011000111000010001101111111111111110111011111110101011111110101101011111001100101100111100011001110100000011000100011000111
10001010000110111110011100011110111001010000100011000100000100100111010000010101001000011100110001111101111010011000101011001011101011111111
10101010111100101000110101110000101100010110001000011101110001101100010101000100011111010110111011000000001010110011111111101001101001100011
10111010000101100011110100010111100001011100111111110101011100100001110111111111111100010010001110011111101011100110000000101100101100001001
11100011110001001010000101110110110111000001100011010001000110111111100000000010001001110111011100110001001001101111011110001110100111111101
10001001011111101111010100110010100011111111110110000111101100100010111111111000101011000001000001100100011100000010010111100010110010100001
10111100000010001100011110011000101010000000000000110110001101101110000000001011101001111011111111101111110101111000110000001010011010101111
10001110111110100111011011001110111011011111111010100011100000100010101111101110001100100000100010001000000000011010111111111111010010100001
10101000100000110001000001100010010010010110000011101001111110101000100001101000101110101110101000111111111111001111100001100000010110110111
11101101101111111101010100110111000110110010111111001111000110111111111101001010111000101000101101100001100001100110001100001111110100010011
10001000100000010001010111100011111110111010110000011100010010000000100001011011100011101101100111001100001011110011011111111100000110111001
10111110111111010111110001001110100000001010010111111001111011111110001101001000110110000111110000011111111010011001001101010001011100001101
10010010100101010110100100011000110111100011010010000011101011000000100111101010010011010000011111110000101000111101100000011111011001100001
11010110101100010010001111110010011100001110010110111110101001111111111110001111011001111111000101000110101101100111111111000001001100111111
11010010001101111011101000000111000111011000111100101000001100000001100011100110001100110001110000011100000101101110001101111101100110100001
10010111100100001000101011111101110110010010001001100011100111111100001000110000100110100100111110111001011100001000100101100100110110101101
10110101110101111110100010011000010011110111101011110110001100001111111110111011111100001110000000100011001110111011110000001110100100101001
10100000110100110100111111001011011000010000101010100010111110111000011000100010001111111111010111111111101000110010011110101110101101101011
10110110100110010101101011101011001111011010101000111010001110000010110011111010100101000100011100000010111010100111011010100100101100001001
10010010001111000101100000000001100000001110111110001111100100110110100110001110110100010001110001111010000010101100000010111101100111011111
11011010111001110100111111110111111111101000100011100000110001100011101100100100010001011111000101001011110110100111101010001000110001110001
10011110001100010110011000100001000110101101101010111110111011001000100101110001111111110001011111101000100100110001001011101011100101100101
11000011100101010011000010111111010010100001001000001010001011111110110001011111000010100101010110001110110101111101011010101010101100101101
11010111001101011001111110001100011010111011011101100011101110000000011111001000011010001111010010101010110111000001011010100010100110001001
10010001111001001100110011101001011010101010010101111111000100111111001011100011111011100110011000100010010100010111010000111110110111111011
10110100100011100110011010100011110010001010110101000101110001100001101000001001010000110100111101101011000101111110011110001100100000100001
11111101101110110011011000111110000110111010110101010000011111110111101111111101000110000101101001001110011101001100110010100110001111101011
10000100101000010110010010001100110100000010010100010111010001000000100100010001111111101101000011111000110001011001100111110010100010001001
10110110101101010110111010100101110111111011010110111100011101011101110001000111000000111001011010001011100111010011110001011011111110111101
10100010000111010010001111110101100010001111010011100001000101001101011111110011101110011011001110100001101100000111010100001000110000110101
10111011010110011011100100010100111110100000011001101111110001100100010100100110001011001011100000111111001001011101000110101110010111100101
10010001110010110001110001000110000100111111111100100010011100110111000001101100111001100010001111100000011011010000010010111011000110001101
11011100011000111101011111110111110001100010000110111011010110010001101011001101101101111110111010101111111111011111111110000001111100100001
10001111001111100001000100100100011111001000101100001001000011010111001110011001000000011000100010101100001000010001000010111100000110111111
10100001100010001100010110101101000110011111100110111101111000010011011000110011011111010011101010100001101010110100011010001101111100100001
10111101111010111111010010101111010000111010110010010100001111111010011011111001001000010110001010111111001011100111111011100100000001110101
11110001000000110001011010100001111101100000111011000111011000101010110010011101101011010000111000000001101001001110001001110111111111000101
10000111111110100101011010111100001101001101100011101101001010100010110110110001001011111111101111111011001100011000111101000001001010010111
10110100011010101101110010000111100001100111001110100001100010101110100100010111101000100011000000010010011001111101100001111101011000110001
10011101001010100100011011101110111111110110011010001011111110100110001110110110001110001001101111110110110011010001001111101101010011111101
11010001101000110111001001100000100000110100110000111001000100110011111100100100111000111100100001000010011000000111011010101001000110001101
11000111101111110001101100101011101110100101111110101101110101111001000110101101100011101001101100011111001111110010010000100011011100100101
10011110100000011100100110101110001010001100010000100000000100101101010010101101001110001011000111111001100010011010111011101111111001110001
11010100111101110101110100101100111011011111010111111111011110000101011000100111011010101011011101000011111011001010001001100110000011011101
10000001100001100101000101100001100011000100010011000110001011101101111110110010001000100010000000011010001001100011101100110010111110000001
11101111001100001101011101101011001001011101111000010011111000101100010000111010101101111110111111110000101101101110001110011000100000111111
11001000011111011101000100111010011011011001001111111001000010100111000110001011100101010000011000011111111100100110111000111101111011110001
10011011110001110001110110011000111110010011011000011101011110110001111110111000110100010111110011010001000110110010011101110000110000011011
10110010000100100111100011001111100000110111010011010100011010010111000010011110110101010010100111010100010110100111001000011010011111001001
11110110110110001100101001100110001101100100000111000111010011010010011011010010010101111010101101000111110000101101101111000011010001101101
10000100011111100101101100110000101001001110111101110110000110011000111111011011010101100010101001111101011111101100100001111111110100100101
10111101110000110000100110011111101101011000001000000011110100111110000100001011010111001110100011000000000000100001111101000001000110110001
10011000100110011110110011010001111001001110101110111001100101100111110001100010010000011100101011011101111110110100000100010111011110011011
11000010101111000111111001110100001111100010100011101100111101001100011111111110111111000001111010010100001010011110111110110001010011010001
11111111100011110011000011100111100110111010101000100110001000011101001000100000110001110100110010110111101011001010100011100100000110010111
10000001111000110110011011001101110100001011111110101111101110111001100010101111100100011110010110010011001011101010101001101110101100110101
11101100001110100000111001011000100001101000001000100110100110000011101110100000001111000011010111000110011000001000101100100011111001100101
10001111100000111111101101001110101101101111101011110010110011011111001010111111111001110111010001110110110010101011101110111001110011101101
10111000111110100100000001100000100111001100001000011000011001010001011010101000011101010010011100011100100110111110001010001100100110101101
10011010000111110001011011111110110001011001111101111111001101110100010000100011000000011010110111000101101110011000111011100110101100000101
11000010110001011111110001101100111101110011000100100001100100010111010111101111110111011010000101110101111011000010100000110100100111110001
11111111111101000001100111001001100100010110010110001100101111010011110100001100100101010010111100010100010001111111110110100101110011000111
10000101000101011100110000011011001110110000110111100110101001011001100101011001101100010111100001000111010101000011000010101101011001010011
10110001010101000110011111010010011100011111110001001110100011001101001111010011101101110010001111111100010101011001011010100101001101111001
10111100010001110111000101010111000111010000011101111000101111100101100010011000100100100110111000000001111101001100001010110101100100101111
10001001010111000101110100010011110101010111011001000011101000110100111011000010110101101110101111010111000001100111111011100100110110100001
10101111111100011101000101011001000101010110010011101110001010010110011001101010010101000010100100011100011100101101101001101110010010101101
10100001100001110001011101111100010101000100110110000110100010110111001101101111110101010110110001111001000110100101001100101011011010101101
10111101001111010101011001000111110001110101100100110011101110010011101000101000000101011100100100001101010011110000011110101010011010001001
10100101011010000101010011010000111101011101001111111001111000110110001110111011101101001001111111100111011000011111010000100011000010101011
10001101000010111101010110011010001001010001011100001100100010010000111010001010111001101011010000110011011101110000010111111001011111101001
11101101111010101101011100110011111011010111000101100110101111111111101011101010010011100001000110011010001100010111110000011101110001111101
10000100000000100001000001111000000000010000010000110000100000000000000000000011000110001100010011000010100101000000010101000000000100000000
11111111111111111111111111111111111111111111111111111111111111111111111111111111111111111111111111111111111111111111111111111111111111111111
