1111111111111111111111111111111111111111111111111111111111111111111111111111111111111111111111111111111111111111111
0001000000001000000110000011000000110001010011000000001100000010110000011010000100001110000000000010000000010000111
1101101111011011110000101110010110011100000110011111100110111110000111000010101101100100101110101110101011000110011
1000101000010010011111100110110011001110110000111000110100001000111101101000111000110001100111111000111110010011001
1110111011110110110010110010111011100000011111101010000101101011110000101111100010011011110011000010011000111011101
1010011000010110011000011000101000111101110001000011111111100010000110100011001111111001111110010111001101101110101
1011001110110011000011011111101110001101000101101110100011001110110011111000011100001100100010110101111001000100101
1001100110011011011110000110000111100101011100100110001001101000100110001111110001101110001000011100000011010001101
1011110011000010000111110011110001110101000110110011101100000010111100100011000111100100111111110001111110010111101
1000011001110111110100011001100101000101110110011000111001111110010001111000011110110110001100010111100010110000101
1101111100010100011101011100001101011101010011011110011111000000110111011111110000010011100001010110001000011110101
1000000111010001011001001111011001010100011001000011000001010111100100010100000101011000111111010010101111110010001
1101110001011111000011100010010011010001011101110111111101111100001111000110110111111110010100011011100100011011111
1001010111000011111110111011110110011111110000010011000100000001111010010011100110000011010101111001110101001000001
1011010011111001000000001000110011010001100111111001011111111111000000111001001100110111010000101100100101101101101
1000011000011101111010111110011010010100001100001101000001010001111101101100011001110010011110000110101101000101101
1101111111000100001110000111011010110110111001011001101100000100001100101111010011011000111011101100101001110001001
1000110101101110100100110001001010000011100011010011001111111110100110000110010110001111110011001001101011011111011
1110010000100011110111111011101011111001110111010110011000010110110011110100110100100000000110011011000010000001011
1011000111111001010001011000001010001111000101000011010011110000011001100101110111101110111110110001111110101101001
1001110011011100010100010011111010100011011101111110010111000101011100101101100001000010000000100111011010111101101
1100011000010101111111010110000010101000010000001000110100011111110110100100111101110111011111101101010010010001001
1101011111000100001101010110111010101111111101100011110001110000010000110101100101000001111000001000000111010111011
1001000011110110100101010011100010111100000100111111010111100101011101100100110101101100110011111010111100010001001
1011111000110110111100011000101010000101110110010001000010101111000100001110000100111110100110000010000101111011011
1010101110100010010001111110001011101101010111000101111000100011110111111011010110001010101111111110110100001000001
1000100110101111010111000111111001000101010100011100001110111010010010000011111111100011100001000010110111011111111
1110101100101001000101110000011101011101010101010111100011110011010110111010000000111000101011011010010001000100001
1000101001101101111100011011001001001000010111010000101000000110010000001000110110101110101000001011011101110110101
1011100011001000110001001001100011100011110001000111111010101100111111111111100100000010111010101001111000110010111
1001110111011101100111101111001010111110111101110010001111100001100110000001101111111010001111111100100010011010001
1100011110000100001100000001111010000000000100111010100000111101001100111100001010001111101000011110101110110010101
1001000011110111011111111100011011011011101110001110111010000100011001100110111000100010001101001100100011100111101
1011101110000100010001100111010001110000100011100100001111110101110011110100100011111000111101100101111010001100001
1110001100111110110100110101010100100111111001110001111000100100110110000001101110001111100000110001011010111001111
1000111001101000100110100100011110110011001100111111000010001110010011111011100100100000001101111101000010011100001
1101110011001010001110101101111010011000011110000001011111011011011010001110110101101111101001000101101111000111101
1001100110011011111010100001000011011111010011011101010001110001011000100000000100111000111101010111100011110100001
1100101111010010000010110111010110010010011001011001000100010101110011111111111101110010000111010011001010110101101
1110100001000111010110100100010100110110111101001111111111000100011010011000110000010111110001011001111000100100111
1010111101110001011100101110111101100100100001100000000001010111001011000010010101010101011100001100001101101110001
1000000100011100011001100100000001001101101100111011111101110001101001110111011111010000000111100101011001001000101
1101010111010111001011110111111101100000111110001000010100111111101011100100000000011111010000111111001100011101101
1001111110010001011011000100011000111010010011011111010110100001001001001111101101000101011111100011100110110111101
1100101000111100010010011101001110001111011010000010010010101100011101011000111001111100010000001000110100100011001
1110100011101001010110111001100111100100000011011010111000101111110001011010001111000101110111111101100101101001011
1000101111000011110110100011110101110111011000010010101101100100010111000010100011010100010010101100001101101100001
1011101010010110000100001010010101000001001111111010000100110111000100011111111000010111011010000111111100111111101
1001101000111110101111111111000100011101101000001110110110010001011110110100001111110001010010110001000110100000101
1101001011100011101010000110011111110001111011100011100011011101001100000101101000011101010110010101010010001110101
1001011001101001100011010000110100011011010010111000101011111001100111110100101101000100010011110100011011111000101
1101001100101100111001011010000101001000000110011110101000100011110000110110100101110110111000100101110001101011101
1101011110100110001101001111110101101011101111000010101010101110011110011100110101010010101110110111010100100010001
1001001000110011100001101000100101101110000110011000001111101000111011001001100101011010000010100010010110101110111
1011101011111000110100111010110001000011010011001110111000001010010001100011101101000010111110101000110111100110001
1010001010001110011110100010011111111001111001111100010011111011000111111110101001011111100000111111110001110011101
1010111010100011001111101111000110001100111111000101010110100011011110000000101011000101101111100001000101011001101
1000101010110111100111000001110100100110010100010111110110001001010000111101100011110100100000001101111100001100001
1101101011100010110010010101000110110011010001110000100011111101110111110001111110010110001111011000001001011110111
1000100010001000011000111111011100011011000111011110101000011000000100010111000111000100100001111101101011110000011
1110101110101111111011110001000110110001111100000010111011010011111101010010010010011110110101000100101011000111001
1000101100100100001111000101101100011100000101111010001110010110000111011000111010111000011111010111101000010011101
1011100101110101100110011101100101000110111100001111100100110110110000001111111010110011110000010001001101111110101
1001110101011101110000110100110111110010001001011000110101110100011011100100010010011010000111111101011001100010001
1101010100001001011111100110010100011111011011010010010101000101001010001101000111001110111100110001001111001011011
1001000110111011011010101111010101000011000001010111010001011101111010111001010011100100010001100111100100011001001
1011011110010010000000100001010001111010010111010011011111000111100010101011111000110101011011101101110001001101111
1011000000110110110110001011011101011010110100011001001011101100001110001000101101100111011000101000011111111100001
1010011110010011100111111001001001001010111101001101100000001001111100101110100001001110010010101011000000000111011
1011110010111000101100001011101101101011100001101000111111111011000001111100101011011100110111101011111011110001001
1000011000001110101101100000100101001001101101001010000000001001111100100001101110011001110100001000001010111101101
1111001111111000100100111111110101101100100111111011011111101011000111101011000100110011000101111110111010010000001
1001100100001101110101100010000101100110110011100001110000101010010000101110011101100110010100100110011011000111011
1011110001011101000111001000111100101100011001001100100110100010111110101100111001001111011110110011001001111100001
1000011111001001101110011110100110100101111100011001101110110110100100100101101011011100000110111001101100000111101
1101110101100011100010110011110010101100111101111111001100100010110001110101101001010101110100100011101111110001111
1000000100111110101000111001100110101110011000101000011001111010111011100100101100010100010101101001001000111100001
1111010001101010001111101100001110100011001110001010110011000010001000101110100111110001110101001101011010100101101
1100011011100000111010000110111010110111101000101011100111111111101010001010110101100111000101100111010010001101001
1001110010001111101000101100010010000001101111111010001100000000001111111000100000001110011101110100010111100111011
1011000110111000001101100101000111111100100001100010111111101111111000011011101101011100111001000101110010001100001
1001110010011110100101110001110100001110111101001110000001001000100011010001111001111001101011010000011011111001101
1100011111000010110101011100110001101010010100011011111101011010101111011100110011000011001011111011001000011011001
1001010001111000100100010111100101000011000111110000100001001010101001010110011110011011101000001111101111010010011
1011010100101111101111010100001111111111110000000101101111100010101011010011000000111010001111100101101000010110111
1110010110000010001001000101011000110000000101010100101001001010001010011011111111110010100101110101000010110110101
1000110110111010111011011101010010100101111111111111101011011111111010111000000001010111110001010001111010100100001
1011110010011110100010001001110110001111000010100001001011000100001010001101111100010000100101011100011111101111101
1001010111001100101010111011000011111100011000101100011001110110100011100101001001011110001101000111000001101000101
1100010101101001101110001011011111010001111110001111111101010011110110110101011011001011111001010101111100100010101
1111010100100011000111101000010010010111000011111000011000011000010000010100001001100000001011010100000110101110101
1100010110111111010001001111111000110010011110001101010011001101000110110111011100111110111011010111011100100010101
1001010010000101011100011000001010111011001000100001000111100111111100010101010110010100010010010000010001111010111
1011111011110001000111111101101010001011100011101111111100110010100001110100000011010001010110110101110111000010011
1000001000010111110010000001001011011001110110001100000110011000101111010111111110010111010010011111000101101111001
1011101111010000111011101101011110001100011100111001011111001110100010010000000010110001111011000110010100001011101
1000100010011010101000100101000011011111000110110011001011100000111010111111111010011100101001101100111101111010101
1110111000111010001110110101101000000101101100010111100010001010001000001000101011000110001100101001101000110000101
1010001111101011100110111100111111110100100111010000111000111110111111100010101001010111111110001011000010011010101
1011100110001000111100000110000010100101110011011010011111110111100010111110101101010000100011101011111111000010101
1000110010101010000001010011111010001100011001001111000000000100001000000110100101110101101001101000000111101010101
1101111011100011111111011000110010111110111101101101111101111101111110111100101100110101001101001111110010111110101
1001101000110110101001111110000110000010000101001000000100110001000010011001100110011100011000011010011010100010101
1101001010010000100011000011011111111000101101011011111101100111011111010011110011000111001111110000110010001011101
1000011111011010001110011011110000001111111001010000001000101110000001000110111001110001100100011010010110111001101
1011001101010011111100111001000111100001110011011101101011100100111011111100011101010101110001001011110100101100001
1001100100010110000001101101101100111100100110001000101010110101101000000111000000011101011101100010000101100111101
1011111101110110111111000100001101100110101111101010101000110101101101110011010111010001000000111010111101101110001
1000001001000010110000011111111000110010101000001111101101100101000100011001111110010101101111100010010000100000111
1011101011101110011101010001010010010110101101111000100001001100010111001101000000110111001000111011011110101111101
1011001001000011011001000100000111110000100101100010111011011111110110011001101110010001011010001111001000101000001
1001011101111110010011111110111100010111110101001110001010011000011100110011000110111101111011100101100011101110101
1101001100011000110110000010110001000101000101011011101110110011001001110111110100010100101000110000111111000100101
1001100001000010100000101010000101010000010100000000100000000111100011000000000101000110000010010110000000010001100
1111111111111111111111111111111111111111111111111111111111111111111111111111111111111111111111111111111111111111111
