111111111111111111111111111111111111111111111111111111111111111111111111111111111111111111
001000000110100010001000001100011000000000000011000000011110001011010100000000101000000001
101101110010001010101011101001000011111111101010011011001100100000010001111110100011110101
101000111011011000111001001011111111000001101011110001100110101101110100011010101010000101
101110100010011010011101011010000000010111001000110111110011111000100101010010111010111101
100100101111010011000101011000101111111100011110100101111000011010101111010110001110001001
110101100000010111111101001011111000110001110010101100111111001010001100010011101100101101
110100101111111100001001100001010010011011000110000110010001101011100110111000001001100111
100110111000101001100011111111000111001010010011111111000111101111001100100011111111110001
101100110010000011111110000010011101100010111110000110010010100001011001101110000000011011
101110000111111111011000111010111000111110001100110011011000111101110011101100110111001011
100011101100000100010011110000100010001011101001111001001010001101100110100111100101101001
111000100110110001110110011111111111011000000011001101111110100100101100110100001100101101
101110110000011111100100110000000001000011011110011100100010110110001101110001111110101101
101010011111010000001101100111010101010110001000110110001011100011111000011111001100100101
100011000011110111101000001100011101111100101011100011111000111000101011000011100001110001
101001111000010000111101111001111000001111101000001000011110100010001011110110101011111101
101111001111010110000100100011001111100110001111101011000110110111100010000000101011100001
100000011101011111110101101111100010110010101000111001101100110000111110111101101001001111
101110111001000001000101001001001000111010111010001011111001100110011000100111001101011001
101010001011111100011101011100011110100010010010101010100011101111001110001100011001010011
100011100010000111110001010001111000101111000111101000101110101001100011100101111011011011
101000101000110100010101011111000010101000010001101101100110001100111000110100101010010001
101111111101110101011111000011101110101111111111001100110010111001101110010110101000111101
100100010000100001001010011010100010100010000010011001111010010011101011010100101111101101
110101011110111111100011110010001011111011011011001011001011000110000001010101101000100001
111101000000100000111000011010101000011001010001101000011001110100101111010100000010110111
101001111010111110011111010011101111001100011101001011011100110001100110011111111110110001
100011100011100011000010011000100101100111110100011001010110011111111100111000000010011011
110111001110001001101000111110110100110100010111111101010011000000000001101010110111010001
100100011000111101001011110100100110010001000101000001011001111111111100001011100011010111
110111110011100101011010000001101100111111011100011011001101000000000111101001110110010001
100100011000001101110011011111100001100001010001110001100101011111110100001101000100111101
101101001111100100110110001000110100110100010111000100110101010001010001011001011101100001
101001100000110110100011101010010110100101110001011111100001000100011011110011001001111011
101011111110010100111000001011000011101100111101000000110111111111001111000111100011000001
101010000011000101101111111011111111001110100101111110100010000101011000011100111111101101
100010111001110101100000001001000010011010110100001010111010111100010011110110110000001001
101110101100010100111101011011011000111010000111100010011010110001110110000110100111111011
111000101111010110000111001001001111101011110100001111010010100111010000101100001100110001
100010100001011100110011101011100011000000000101011000010110101101011111101001101110011011
101111110100000111111010101010111001111111111101110011010010100100001100001011000011010001
101000010101110000011010001010101101000010000001000111111000110001100111101001111111000111
101011011100011111000010111000001100011000111111011100011011111111110011001100010001110001
100001000101010001111110001111100111111111100001001001001110000110011001101001010100011111
101111110111110100010000101010110011000000001111011011100110110011001011001011000111000011
101000010001100101010111100000011000011111100100010000110010011000011001011011111101111001
100011111011001101010100001111001111011000110101110110111010111110111011001001000101001101
110110001010011111010101111011100100001010011101100011100010010100010001101100010000011001
111100101010111010010100011000001101111011001001001001101011000101110100101101111111110011
101001101010010000110111001101111001011011101100011100101011011100100110101000100001100111
100011101011010101100011100111000011001001101110111101101110001101101111101010101101001101
110110001010010111001000110001011111101100100011111000100000111001000101001110101100011101
100011011000110010011011111011011010000101111000110011111111110011011100011100100111011001
101001001111111010110001101001000011010101001101100110010001010111011001110101110001001011
101101100001010011110111001011111000010100011000101111000100010010001011010101011101100011
100101110100011001000000011000011011110111011010101100010111111010111001000001000100111001
110100011111001101101111111011010001100001001110100101110110001010001101101101010110011101
100101000011101100111000010001000100111111100100110100110100100011100100111001010011000111
101111111010100110100011010111111110100000001101110110011101111110110110001100011011110001
100110010010110010001110010100000011101111111001000011000100000000010011100101001110011011
110000110110111011111000110101101111000001100011011111110101010111011010110101100100110001
110101100100000000100011100100100010011011001111011010100111110010010010010111110001100101
100111001111111010001111001110111000111110011101000000001100011011110110110001000111001101
111110011100010011111101011110011111101000111001111110111001000010000100011101111100011101
100000110001011111000100001100110100100010101011100000010011101110111111000100010001111001
110111100101000010010101011001100001101111100000101111110110001000100001101111010111010011
100110001101011011010001110011101011101011001011100000010010111011110101001000010011000111
101100111111001010011111000110001001001010011001110111011011110010000100011011111010011101
101001100011011010110010011111011011011000111100010011111001000110111101110010000010110001
101011001001110010111010110000001010011011110111011001000011011100100000100111101110100101
100010011100010110001010011010101110110001100011001101011001001001101111101100001000110101
101110110111000110100011001111100100111111001001100101001101100011111000101001011011100101
101100100001110011111111101100001101100001011100001101100111111010100010001011011010001101
111001110111011010000100100001101000101101001111111101110010100000101111111001001000111001
100011100011000010110001110100111011101101011000010100011000001110100110001111101111101011
110111001001011110011101000110010010000101010011000111011111011011110011100010001000000001
100100011101011011001101011111010110111101000110010000010101110001011000001000111110111111
101101000100001001101001011001110100010001010111111101110000100100001111111111110100100011
100111110101100011001011000011100101110101011100000101010110001111101000100010100101111001
110100011111110110011001110110001101100111110001110101000010111000100010101000001100011101
100101011000011100111100000100101101001100000101000101111011110010001110001111111111010001
101101000011001101101111011101111001011001111101011100011110000111111000111000001010010111
101001111111100001000001110001100011001011100111010001001000101100010011100011100010110001
100011011000111111011100110111001011101010101100011111100010101001011111001110001010011011
101110010010100000000110100010011110100010001001110001111111111011000110011010111011001001
101011000110111111110010101110111100101111011011000100000001100001110100111010001111101101
100010011110110000011110100110001001101100001000010111111101001011010101100011100101000101
101000110000000101000000110000100011000001101010110000000100011000010000001000110000010000
111111111111111111111111111111111111111111111111111111111111111111111111111111111111111111
