11111111111111111111111111111111111111111111111111
00100010110001000110011000001000011010001111000001
10101000000100010011010011101011010000100110010101
10101101101111111011000110001111000111110000111101
10111000100000110000011110101000010100000111111001
10001110111110011111111010111101011111111100010011
11100100100011001100001010011001001000110001011011
10110110001011100111101000110011101010100111010001
10010100101000110001100011100110111010001100010111
10110101111111100100101111001100110010111101110001
10000111000001111110100000011110100111100001011101
10111110011101000100111111110110001101101101000001
10100010110001010001110000000000111000100111111111
10101000100111011111000111111111100010110110000001
10001111101100000110010100010110001110010100111011
11111000001111110100110001010100111000110101101001
10010011111000100001111111000101101101100100101101
11010111010010111011000001110100001001001110101101
11010001000110001001111100000101111011011010100101
10011101101111101111000111011111000011001010110101
10111000101001100100010110000100011001100010000101
10001110001100110110110011110110111111001010110101
10100111111110010100111000110000100001011000011101
10110000000111010001101110011011101101001101001101
10010110110000010111000011001010001001100111111001
11111110111111011100011111101110111011101100011011
10000010100001001001000001001000100011001001000001
11011000111101101011010101011101111010011011111011
10011111110000101011110101001101010010110010011001
10110001100110101001100101100001010111100111001101
10011100001100101100101101111111000101001101100001
11000110111111100110100111000011011100011001101111
10010010001010001100110110010110010110111100001001
10111011100010111001100100110000110000110101111101
10110000111010110011110101111111111011100100100001
10011110001000010110100100001011010011001110111011
11010011101111110010101111101000011001100000001001
10011000100000011010101001001101001100111111101101
10110010111011010010100011011101100110010000100001
10011110001110010110110111000001110011010110111101
11010000100111000100100101111111011010010010010001
10011011110011111110101100000011001010111011011011
10110010011000110100101101011001100010100001001111
10000111001110000101100101001111001010001111100101
11111101100011110100110001100100011111111000110001
10000100001000110110011111110001110100000010011011
10110001011111100111010110010111010001011111011001
10011111000010001101000100110100011111010010001101
11000001011000100000010001100001000000011000100000
11111111111111111111111111111111111111111111111111
