11111111111111111111111111111111111
00001011000000110001100000001100011
10101001011110010100111110100001001
11101100010011000110100011110111101
10100110111011101110101001000100101
10110010000010101010001100011110001
10111011111000101011111101110110111
10101000001011101001000111000100001
10001111101001101100010010011101111
10111010101101000111111000111001011
10110000100111011100000010010011001
10100101110100010101111011110111101
10001100010101110000011110000000001
10111111000100100101001000111111111
10101001111110111101100011100000001
10001100001100001000111110001011101
11101110100001101011110011011010001
10100011101111001001100110001110101
10111001001010011101001100111000111
10101101011010110101011001100010011
10001001010010010000010011101111001
11101011010111010110110110100101101
10001001000110010111100000110001101
10111101010011010100001010011011001
10011001011110011101111111111001011
11000011011000111001001100001101111
10011111110011101011011001100100101
10111001100110001000010011110110001
10001100101110101011110111010011011
11101110000010100001000100010110001
11001011101000101111011110110011101
10011000111111111000010000111000101
10110010010100001101110110001110101
10000111000001100001000010100000000
11111111111111111111111111111111111
