11111111111111111111111111111111111111111111111111111111111111111111111111111111
00011000000011000011000011000001010001010100100000110100000000101000100010100001
10010010111001011001101110010101000100000110001110000101110111100010101000001101
10110110011100011100100100110101010111010011100011010001000010001010001011111101
10110011110111000110001101100101110010011000111001111111101110111111111010011001
10011001100011110011111001101100111110111110001101000000100010100000100010110011
11011100001001011001000011001110000100000100100001011110101010101110001110000111
10010111111100001100011110011011110101110110111101010010101110100011111000111101
10110000000111100111110000110000100100010011100001000110111100101001010011100001
10011110101100110100000111100101101101011000110111110110110001111101010110001101
11000010100110000101111101001100101111110010011100010010000100100001000011111101
11111010110100111101000100011110101000011111011001011011111111101011111000011001
11001000110101100001010001110010101011000100000011000010010001001110001111001011
10011111100101001011011111100110101001110110111110011000110101100100100101101001
10110001101111011110000000101110101100100010000111110010100100110101110100101011
10000100100001000011011010101100100110111011010100011111101110010001100110100011
11101110111101111010001110100101110010010001111101011000001011010100101100101001
11001010100100000011111000110100011011011100101001001011111011010110101001111101
10011010001111111110001011100111001001001110100011101001000000010011101100010101
10110011100100011000101010110001101101100110101011001101011111111010001001000001
10111000110001001101101010000100101100110010001110011101001000001110111011111111
10100011110111101101100010110111100110111011111100110001101111101000100010000001
10101001000100000100111110010000110010001000100110000111001000001101110110111111
10101011011111110110100011111010011011101110110011111100011011100101010010100001
10001001011000010000101000001110110000100100111000000101110010110001011010001101
11111101000011011111101111100010000101110101100011111101000110111111011010111101
10000001111111000001001010111011010111010001101000000100011110101000010010001001
10111111000001111100011000001001110010010111001111110111110100001010110111011011
10011001011111000111001111101100011010111100011000100010100001100010100100010001
11001011000010010001100000100101010000001001111010001010001011111010101110110111
11101000011000110100111110001101010101011011001010111110111011001110100010010001
10001011111111111110100011111111011111110010011011100000001001100100111011011011
10111000001010001000101000000110010000100110110001001111111101110001101010011001
10101101100010100010101111110000110110001110100111011100010100111111000011110011
10100100111110101111100100011011110111111000101110010101000110000010011111000111
10110110011000101000110101001001100100011101101100110001110111111000110001011101
10110000110010111010010101101100110101000000101001111101010001011111111101000101
10011011100110011011000100101110010001110110100011101001011101001100001000010001
11001111001111110011111110100011011111100011111110001011001001101001101111111101
11100110011000000110100000110111011010111001000000100001100011000011100000000001
10110000110011111110101111110001000000101101011110110111001000011110111111111101
10111111110110000010101001000101111110101001000111111100011111110000110000001101
10001000010100101000101101011111100100101011010100000111110100000101100101111001
11100011000101111110100001000010110001101001110001010000100101101101001100001011
10001111111100100011111101011000100101101100111111110110101101001001011111011011
11011000000001101001110101111110101111000110001000110010101001011011010101001001
11010011111100001100100100110010100010010011100010011010100011001110010001101011
10011010001111111110001110011010111000111010111111011110101111100110111011001001
10110011101000001011101011000010110011101000010100001100100110110010010010011101
10111000001011101000100001101110000110001111110001111001111100011011010110110001
10001110101001000010001011100111110110100110000111010011000001011001010010010111
10100011111101010111111010001100011100110000111110000111101111000011011011000101
11111001000101111100100010111001001001111111100011101101100001111110001011111101
10001100010101000110001110100011011011000100001000001000110100100011100010100001
10100111110101010011011000110110010001110001011111111010011110001010111010001101
10110100000100011001111011100111010111000111110000000011000011111000011011011001
10100001011101111100001001110001110100011100100111111111101000000011110010011111
10111111001111000110111100100100010110110110101110100000101111111111000111000001
10100011100110010100001110111111010110100000100010101110000100011000011111011101
10001000111100110111011000010001010010101011101000100011111101000011111010000101
10111110011001110001000011000100011010101001111110111000001001111111001010111101
10001011000011011101110111111110110010111100110000101111101011100001011000001001
10100011111010000100010110000100010110010110100111101101001001001100010011111011
10111110001000110111011100110111010011000100101100000001011101111101010110001001
10010000101111111100010001110011011011110110100101110101000100001001010110101101
10110111100001100001110111011001001010000100110101100101101111101101000010100001
10010010110100101111000101001101101010101110010100101100100010100111111110111111
11011010000110001100010100011000111011101111010101101110111000110010000010000001
11111011111111111001111101001110001001000101010111001010011101111000111010111101
10000010001000000011101001101011011101110100010011011011010000011111100010110001
10101110100011111110001101000010010101000110111000010010010111000000101110100101
10111000101110001100100111011110110001011100001111110110110100011111100111101101
10100011111000101001110100001000010111001001101000000100010110110001110001101001
10101111010011101011010001011011010011101101000011111101110010010100011100101101
10001000000111001011011111001011111010100101010110000100011011110111000110100111
11101110111100011010000101101000110000110101010100110111001001100011110110110001
11000100100101110010111100001110011110010101011101110011101100001110100100111011
10010101110000000110010001111011001011010101000101011010000111111000101101101001
10110001000101010011000100000001100000000101010000001000110000000010100000000010
11111111111111111111111111111111111111111111111111111111111111111111111111111111
