11111111111111111111111111111111111
00000111111000110001101000010000001
11110011110010010100100011000111011
10111001100111000110001111111100011
10101100111101110011111100010001001
10001110100000011000001001010101011
10100010101111011101011011010111001
10101010001001001001110011010001011
10111111111101101111000110011101001
10100001000100100110011100111001011
10001100010110110010110101100011001
10111001110110011010100000001111101
10011011010000110010101111111101101
11010010011110010110111000110101001
11110111000011010110000010010100011
10100110010111010011011111010101111
10001100110010011001001100010000001
11011101111000111101011001011111101
11010001001111110001110011111001101
10010111100010000111000110110011001
10110000001110111110010100000111011
10011011111000100000111111011110001
10111110001011110110010001000011101
10000100100010000110110101101000101
11010101111111010011100101101111101
10010101100000011000101100100001001
11010100111111011110000110101101011
10010110110001000111111110111001001
11010010010101010000100000100011011
10011011000101110101101111101110001
10111001111100011111001010001000111
10001100000111001010011010101011101
11101111110011100010110010101000101
10000000011000001000011000100010000
11111111111111111111111111111111111
