111111111111111111111111111111111111111111111111111111111111
000100000000000000000000010001100000001100010000010000000001
101110111111110101111101110100101110100111000110110111111011
100010110000011100001000100110000011110010010010000100010001
111011100111001001101010101111110111011011111011011101000101
101001001101101111001010101000010001011000110001110001111101
101100011000100001111010101111011101001110100111000111010001
101111111110111100010011100010010001101000101110010100010111
100001100010000111011000111010110111100011111000111111000011
101101001011011101011110010000110100001111000010100001101001
111000011011000001000011000111100101111010011010101100111101
100011110010011011111001111100001101100000110011101110001111
101110100110111010001101000001111101001011111110001011100011
101100101100100010101100011111100001011001000100111000111001
100110101001101000100111110101001111010011010001101110101101
110010101101001111110000110100011100010111011111000000101001
111010101001011100011110000101111001110100010001111010101011
100010001011010001000111110100001011010101111011100010001001
111011011110011111010000000111101011010001000011001111111101
100010010000110001111111110000101000011111011010011100001101
110110111101100100000000011010101111000101011010110001100001
100100010000110111111111001111101101110100010000100111111101
101111011010100110000001100111001000110001110111101100001101
100100011010101100110100110010011010011111010101101001111001
110101110010100111100101111010111011110100000101001100010011
100100000110110000111100010010101011000101111101011111010111
101111111111111110010001010110100010010101100101000100010001
100100011000000011011011010100111000110100110001110110111011
110101000010101110010011010001110010100110111011010110110001
100001111111100011000110011111100110101110010011010010011101
110111000001111001111111010000110110100011011000011011000101
100001110101001101010110010110100011110111001101001001010001
111100100101011100010000110100101001100001100001101101111011
100110001101000111000111100101101111001100111111000100010001
110111111101101101111101101100100110011101100100011111011111
110000000100001000101000101110001100110100101101110001000001
100111011111100010001110100011111001100110101101000101111101
101100001000111111101000111010001011110000101000011111100001
111001011010110000001011110010111001010101101010110000101101
100011001010100111111011000110001100011100101011100110101111
110111011010001101000001011100100111000110001001001110100001
100100001011111000011100010001110101101111011011011100111101
101111101000011011110111110111100000101010010010010110100001
101000111111001000110000110100101110100011110110110100101101
100010000101101110011010000001100010111000000100100101100101
111111010000100011001111111100111010001110101101101101110111
110000010111111011100000100001100011100011111001001001000001
100111110011001000101110111011001110101110000011011011111101
101100111000011110111010001110011000001000111111011010000001
101001101111001010001011100100111111101011110000010011011101
101100000011100011101000110001100000111011000101110111000111
101111011110111011001010111011110110010010011100010100010001
100001000000100010011110100001100111011010110111010110111101
101101101011101110110110001100101100010010000001000100000101
100101001001001100100000111110100111000111111101111111101101
110101011100011001111111100010110001111100100001000000111001
100101001111111011110001101011111101010001101111101101100011
101101111000000001100100101001010001000101000000101101001011
100100000010101100001110001100000101010100011010001000011000
111111111111111111111111111111111111111111111111111111111111
