1111111111
0000110001
1010011101
1111000001
1001111011
1011001001
1001011101
1011000001
1000010100
1111111111
