11111111111111111111111111111111111111111111111111111111111111111111111111111111111111111111111
00100000101011000011000110001000001100010001100000010000011001100000110000100000010110001100001
10111010001010010110010010101101100101010100101011011011001101001010011010110111010011100001101
10011011101000110010111000100000110001010110001110010001100001011011001010010010011001101111101
11010010000011111000101111111111111111010011111100111101111101111111100011011011011100001000001
10010110111110101111100000000001100010011000100001100001011000000000110110001010001111011011101
10110011100110100011001111101011001000111110101111110111001111111110110100100011100001111000111
10011001110010101000011000001010011111111100100010100011100000100010010111111110111100001010001
11011100111000001111111011101110111000111001111010001000111110001011010001001000000111101011011
11010110001101111000101000111100100010010011000011111110011000101001010101101011110100101001011
10010110100100110010101110011001101111000111011110000011001011111111011101100010110001101101001
10110100110101100110000011001100100101011110010000101001101001000001010001001110011101100101101
10100101110100001111111001100110111100010011011011111101101100011011000111011011000100110101001
10110101010111111110001101110000100001110110010001010100001001111001111101010011110110000101011
10010100010010001100100100011111101011000010110101000111111011001100011000011000000111111111001
11010111011010100110110111010110101110011010011101101100011001100111001101110011101100000001101
11010010001000110010010010010000100011111011000100100101001101110101100001000110001001101100101
10011010111111111011011010111010111011000001110110110001100100100000111111010110101100100110001
11011000100110011011010010000010000010011101100000100111101110110110110001011100101001110011011
10001011101100110010010111111111111110110100111111110010100010100110100111001001101011011010001
11101000001001100110110000001000010000100110011010011010111000110010001100011011001010011011101
11001111101011001100010110100011011010110011000000110010001111111011111001110010011000110010001
10011000100010011111111100111010001011100111111110100110111000011000000011000111001110010111011
10110010101110110110001001100011100011001101011000101100011011000011111110011101100011010100001
10000110111000100100101111001110111110011000010011100111001011111110000111001000111001010111101
11111100010011110001101100011000000000111110110110110001100010100010110101101011101101110000111
11000111000110000101000101110011111010000000010000011101001010001010100000001000000100111010011
10010011111110110111110101011000110011111101111011001001011111011010111111111010110110001011001
10111010001100010000100001010010100110000111000001111011010100001110010001001010011111101111101
10110000111001111110101101010110110011010010011111000010000101100111011100011011001010100100001
10011111100011100000101111000010011110011000110000011111110111110101001110111011100000110001101
11010001101110101111100110011011000000111111100111111000010010000001101000110000111101111111101
10010101001010100001110011111001011111100001001100010011011011011101101010011101101000011000101
11010100011000111100111010001111111000101011011111000110001001010001001011001101001011110010101
10010111110010000110011110100110001010101001000010011100101100010111011001100000011001000110101
11000100011111110011001100110000100010001011111010111001111111110100001100111111111100011100101
10010101001000000111100001111111111111111010010011100011010001000101100111100000001111110001101
10111101100011110010111111000000000100010000110110001110000101011100111110001111011000011011001
10011000101110011010000000011010111101010110110100111100111100010110001000111101000011011000011
11001011101011001011111110111110100001000011100101100001100111110011100010011001010110010011111
11101011001001101010001100100011101111101111001100001111110010000110111111110011110100110110001
11001010011100001010100101101001001000100110011101111100011000101100001001100110111101100010101
10011010111001101000110100101100011010110100110001000001001011100001101011001100010000111010101
10110010100011001111100001100110111010011101100101101111101010110101101010011111010111100010101
10110110111110011000111100110011100011000100111100001000101010010111001000110000010100001011101
10011100100000111110100110100111001111110110000111111011101000110010011101110111010111111000001
11000001101010100010001100101100011010100011101100001001001010011010110000000100010010001111101
11111111101110001000101101100001110010001000100101101101011011111010010101111111111010100100001
10000000100011111111101001111111100110111111110100100100001111000011010100000100001000110101101
11111010101000010001001011010000001100000000010110110111101000011110010111110101011111110111001
10001110101110110101111010000101101111111110110010010001100011010010110000010001000101010010011
10100110100010100100010010101111000101000100011011010100110111111000111111111111101100011011001
10110000111010001111000110100001111100011101011010011110011100001110000000100001100001001001101
10011110100011111001111111101100011001001101110011011000110001100011111110101100101011101101001
11000011101111010011000011000111001011100100010110001011100111111001101010100110101110001101101
11011000000110000110011110010001100000110111010011101010001100001100100000001100111000101001001
10011111111100110111000100111111111110010001011001001000111001011110111111101001110011101011011
10110000011001110101010001110001100011110101001101011111110011010100100000111011100111001010001
10111011010011100100011111000100001001000111011101010000010111010001110110110010001100011010111
10001001000110101111110001101111111100011100010101011101000001000111100100100111011101110010011
11101101111110000000010100101000101110110001010001000101111111111100001101101101010101000111001
10101101100011111111010110001110000010100111010111110101100110000001111101000001010001011101101
10100100101001000110010011111100101000101110010010000100110000110111000101010100011111001100001
10110110001101110000111000011001111011101100111010111110010110010011110101110110110001100111101
10010111100100111110111011001100011110001001101000100011010011111001000100111111100100110011001
11010000110110000100010001100101001100101011001111110111010110001101011110101000101110111001011
10011010010011110111011100110111100101111110011001000010011100100001000010000010001000011101111
11001111011001010100001110010001110101000000111101010110111001111101111011111111111011000100001
11100110011101010101100111011100110101011010000001010010010011001111000001100000001111110110111
10110010110101010111110011001110100100001011111111011011000111100110011011001011100110010010011
10011000100000010011011001101010101111111001000100001011011101110100111110011010110010111011001
10110010101011111001001100100010101000001100010001111001110000100001100000110010011000101011101
10010111111110001101011110110110100011011111111111001100100110001111101111100111001110001000001
11000101100010100001000010100010111110001010000001100110001111101100001100001110011011101111101
11011100001000111111101110111010001000100011111100001111111000101001111001111000110001100110001
10010110101111110000001000011111101111111000001110100100010010100011001011000011100100110100111
10110000101100010111111011000000000100011111100100110101000111110110011010010110001110110101101
10010110111001010000011001101011111101010001110110010101010100010000110010110010100011100100001
11010010010011010101001100111110000001000100110011010101011101011110100110011010110111001111101
10011011010111011111100110011000111101111110011000010001001001000011101111010010010001011001001
10110001010001000001001111001101100111000111001101111111101011111001100001110111010111001100011
10100101111101111101011001101001101100010011100111000001101010101100110111000111010001100101111
10110100010100010001001011001011001001111010110001101011001010000110010110010010010101110100101
10010111000111010111100000011000011011010010100101001010011011110011010100111010111100110110001
11010011101110010000110111111011001011010110001101101000110000111001000101101110101110100011101
10010110101000111110011100000001111010010100100100101111111110011100010101100100100010001001001
10110010101011100011010001010101000010110111101110111000010011000111111100101101111011111111011
10111000101000001110000111111111011110010000101010000011000111101110000110001001010000000100001
10101101101111100111111110000010010011011110100010111111101100100000110010100011000101111101111
10100000100010001100001100111000111000001010111111100011000101111111111011101000010101000001001
10110111111000111001100101101111111010101000110001001010010100000000011001111101111111011111101
10011100011111110011110001000110010010111011100101011000110111111011001101000101000010010000001
11000101001100010110111111010011000110000000001101011111110100011011101100010111011000111011101
10010001100001000100000000011000010010101010101000010000000001000010000101010000001010000010000
11111111111111111111111111111111111111111111111111111111111111111111111111111111111111111111111
