111111111111111111111111111111111111111111111111111111111111111111111111111111111111111111111111111111111111111111111111
000100001010000001100011010100010101100000000000010000110000100000000001010101010101000000010100000000101010000011000001
110101101000111100001010000101010000001111111010110110011010001111101100000001000001011101010001011111100010111001101101
100001001011101111111010101101000111111000011010100111001011111001001111111101111100001101010111010001001000001101001001
111111011011000011011010111001111110011011001010101101101010000011011000000100000110101001010001000100011111111100011011
100010010001111001000000100011000011001001100010100000100011101110010011101111110011111011011101111111110100000111011001
101110110100001100011111101111101001101100101011111101111111001000111000111000011001000010010100000100000101010001001101
100000110110100111111000001000101100101110111110000100100000011010101101110011001101110110110111110111110101111101011101
101111100011110110000011111010001110001010100011010110101110111011100001100111100100110100010100010011000100110001110001
101000111110000100111110110011111011100010001001010000100100010011001100001101110110010111000110111000011110011100000101
101110010000101101100100000110001010111011111100011111110101010110011111111100110011010101110010101111001011000111111101
100011000111101001110001011100101000101010100111110101000101010100110010000110011000010100011010100001101001110110000001
111001110001111011011111010101100010000000101100010001111101010110111000110011001111110101000000101100101011010100111111
101100111100110000001000010000111111101010100001000100110001010010101101111001101100000101111111101110101000010110100001
100110000110010111100011111110011000111110101011101110000111111010100001001100100001111101100100001000101101010011101011
110011101111000001111110000111110010001100111001100111010100010010110111011110111011001000101101111011100001011000001001
110111000110011111000010110101000111100110011101001101011101000110010001001010100011100010001000001000001111110011111101
100001110011001100011000110100010100110011001111011001011001011111010101100010101110101110111011111010101000011001000001
101011011001111001111111100101110110011001100010010011010011110001010100110110100100101011100010001111111011010011011101
101010011100110011100001001101100111001101001000111000010110100100010101100000110110000010001110100001000010011010010001
101000110110100110001101011100111100011001011111110011110100101111110100110101110011111110111100111101101111001010111011
101110010010101100101001000110001001001011110100000110000101100100010110011100011000000110100101110100001001101110001001
100111000110001101111101110110101111101001000111011100111100110111010111001111011011010000110101100111111100100100101011
110011110111111001011001000100101000101101010001110001100110010010000001100001001110011111100100101100000001110101101001
111010110001000011010011011110101010001101011100000111001111011011101111111101100011000010110110100110101101100101001101
101010011101110110000111000011101011100100010111111100011000001000111000100001111001111010100010101100100111001101011111
100011000100000100101101111010001001101111110011000101110011011110010010110111001101000000001110100001101110011001000011
101110010001011101100000110000111100100000111001011100010110000111000110100101100001011111101000110101001100111111111001
101000111111110000111110011111100110111101101100001001000010110001111110110101101111110001001010011111011001100000001101
101111110000100110100011010000001100000100101001100011111110111100101010110100000101000101111011010001000011001111100101
100000011010111111101001011011111110110110001100111010100010100110001010010111110100011101100011110101110111100010110101
111111001010000101001101000011000100110111100111110010001010110100100011010011000110111000101110000100010100001010110001
100011101011110000011101111001010001100101110000010110111010010001111110011001011100101010000100111111010111111010011101
101001101000011111110100001111011111001100011111010000100011011111110000111101001101100011111101110000010100011011000101
101100101111000011010111101100001000011111000001011110101111001000100111101001011000110110000000100111110001010011011101
100110100011111000000000101001101011110001010111001100111000011010001101000011000011100110111111101110111111000110001001
110110111000001111111110100011111011000101110011100101100011011011111001010110011111001100110110001010100001111100101011
100100011101100001100000111110001001101100011000110100110110001000101101010010110001111001100100101000001100001101101011
110101000101110101001011100000101100101111011010010110010110111110101001011011100100001011001101111110111110100101101001
100111110100010111011000110110100110100100010011010011010100100010001011001001001111100000011000100010011010110100111011
110010010101010010001111100111110000110101111111011001110101101011101000011101011010111111111101101011010010010110110001
111011000111011000111000101100011111100101100000011100000101001001101101000100000000001100001100001001000111010110100111
101011011110001111100010100001000010001100111011000111111101011100100111101111111111111001101001111101111101010100101101
100010010011011011001010111011011011101110100011110000101101000110110011000000100001100011001101000100010000010001101001
110110111001010010011110001111111000100010001010010111100001110111111001111101101100001111011001010111010111111100100011
110100001100000110111100100110001010111011111111010100001111000100001100110000100111111101011111010001010100000110111001
100101101101111100101001110100101010010001000101010101111101101101011110010111110010000100010100010100010101110011101101
101111101000110001100011000001101111010100010001000100100001001001011111010000011011110101110001111111110100011001000101
100010101110100101001110011111001000010110111101110110001101011011001101011111001000100100000101001010000111001100011101
111010000011101111111100110001011011110011101001100011101001000011100101000001101110101111111111100011101101100110111001
110010111001000100000111111011010010111001100011001000111101011010110001111100111000100010100010001001000000110110010011
100111101101101101110000010001000110011100101010011010011001110010011011000110010010111000001010111101101101100011000111
101101001001000100111111010101111111010110101110110011010011100110110001011111000111100011111000100101000100111011111101
101100011011101110010100010100000001000110100011110111110110101100011101000101111101001110001111110101010110011000100001
100110110001100011010101110101011101010100111001010101000100100111001001010001000000011000100000010101010011001110101101
110010100100001110010100111101010001011101101101000001011101110001101011011011010110110011111101110001011001101010001001
111010001110111100110110001001010100001001000101111101010000011100001000001000011110011000000100100101001101000011111011
100011101011100001100011101101011111111011110101000111011011010111101111011111010000110011110101101111111001011000110001
101111000001001111110110100101000110001010000101010011001110010000101001110001110111100110000111000110001101111101100111
100100011111011000000000110101010000100000111101011001100111000110001011000100110010111111010011011100101100010001001101
110101110000010010111010110101111110111110011001011100110101011111111011011110011010100011011001000101100101010111011001
100111100111111111100010010100100011100011001011000110000100001000100010010011000010001000011101110101110111011110010011
110000001110110000110111010101101011001001101011010011111111100010111010111011111111011101110001010001000001001010111001
100111111010100110000100010111001001011101111000011000000010111110100010001010001000010000111111000111111101101000110011
101100011000001111111101110011011101010100011011111111101010000010001111101000100011111110011000011100010000001011100111
100101001011011101100000011000010100000111001110000001111011101000101000101011111110111000110010110001011111101010001111
110111100011010100001111110011110111111101100110111100110001001111111010001000100000010011100110110111000001111011011111
100001101110010101111000110110100000001000110000010110011101011100010011011110111111000111001111100101111100011011000111
111100100100110001100010010000101111100010111111000011001001000001010111110100100011101110011011001100000101001001110011
101110111101100111001111011010001001110111100001111111101011111011110101100001101000111100111001011001101101101100011001
101010000001101110011011001111111100000010001100000000001001100001000101001100101110000101101101010011000111000111011101
100011110111000100110001101101000110111010111111111111101100110111011100011110100011101101100100011110011100011100010001
110110010011011101111100100100010011100010010010110000101110011100010001111100111010100000110001110000110001001110111011
110000111001110001010001110111011001001111011010000110101011001001011100001001101000101111100101000110111011100100100001
100110001100100111000101010110001100011011010000101100101001100011001111101100101110111000101111101110100010101101111011
101100111110101101101100010010100111110001011010111110000011110111111000100110000100011010001011100011101110000100011001
101111100000100100001111011011110100111101001110011011111011000011100010110011110101110011111001001000100010110111001101
100011001010110110111001001011000110000001100111001000001110011001001110011000011100100111011101011101111011111101101001
101000011111110100100011101010011111111011110001111011100010111111011011001101000110101101010001001101001000110000001011
101011110100000101101110001011011011000011011100100010111011110100000011100111110000101001000101011000011110000111111001
101110000101110100100100101001001010011001000110001110101000000101111110110000111111101011011100001011110011111100011101
111000110100110110110001111101101000111101101111111000001110110101001100011110001000101010000101101000010111001001000001
100011100110011100100111100001000010100000100001011111100010011101101001010011011010001000111111001011000001101011110101
101110101111000110110000110111101111111010110100010000001011000100100011011001001011111110110001111011101100101001100101
101010000101010010011110010100000110001110100111000111101001110110110111011101100010001100100100011010100111100011001101
101000110101011011000111110101111100100010110101111100001100100110110101001100111110100001101111001000110001101110011101
101101100100001011010001000100100101111010000100000101101111101100100101100110000110111111001001101101111101001100110001
100111001110111001011100011110110101110010111111110100111000101001101101110000110010101010011101100111000100011001111101
110001100010011101010111111000000100100110011000010001100010001011001000011111111010000010110000110110010111110011011001
100100111011110001000100001111110110110011110011011011001110101001011111011000001011011010111110000010110010000110000011
101110110001000111110110100000100110011010000110001110011100111101000010010010111001110010000111111000111000110111111001
101010011101101100010010111010110011010000111111100110110001100001011011000110001101100110110000001111101111100100001101
100011000101001001111011100010010110010111100000110010110111110111110001111100100100111100011111011000000010001101100101
111111010100011100110010001111011100110011001110011000100000100100000111000110101110001001110001001110101000111101110101
100001110111111110100111011010011001111110011010111101111101101111101110010010100011101011000101100011111110000101010111
101101100100001000001100010010110011111000111010000111000111001000001000111011111001101001101100111010000011111101010001
101000101101011011111001110110010111110011100011110110010110011101111101110000010011001011000110001000101000000000011101
101110001101000010000011000111000111100110110110010000110000110001000000011011000110011000010011011111101111111111111001
100011101001011111011011010011110011001110000000111011111111111011101111001110011100111011111111110001001000000001100011
101000111011000001110010011000111010011010110110001110000000110001000011100011110001110001000000000101100010110111001001
101010110001111100011010111110011010111010010011100100110110011101111000111000100111000101011011111100111010011100011101
101110011011000111001010100011000010101011011010001101110111001101100010001010001100011111011110010110001011010001111001
100111001001010011100010111011111110100001001010111001010011100101001111111011111101110001000011000011101011010111101011
110101101011011000111010011010000100110111011011100011011001110001011000011001000111100101101001010110001110010010101011
100000101010011110001011000010101101100011001011001110001100111101110011001101010001001100101101110000111100111010000001
101101101110110011101111111000101001001001101000011000100110000111000111100100010100011110100100011110000101100011011111
100111001000111000100100001111101011011100101111110010110011101110011110110111011111110010111101000011110111001110001101
101100011011101010110001101011001001001110101000000110011000100100110000010100011000011010001111111000100001100110111001
111001001011000010111111001001101101100010000011111111001111110001111101010111110011000011100000010010110100110010000011
100011101001101110001000011101000100111111111111000111100100010100110001110001100111101000111111011110011110111011101001
101110101100001010111011110001011110000000010001010011101101011110010100111101001110101010010101000011000100001001001101
101100001111111010011000110111000111111111011101011001001001000011000101100001101000101111010001111001110111101101111101
100101111000000011001110010010011100000001011001001101011011111011101111001111001011100001010101011100110100101100000111
110101100010111111100011011000110001110101001011100100011010001010001000011001101000101101010100010110010110100110110001
110101001110010001111001001111100111100101101000110111001010101010111011111100001101111101110111000111010110110010011011
100111011011000100001101100001101101001101001010000001111010111011100010100001111100100000100011101100010100011011110001
101100010001111110111101111101001001011111011111111111000010110001001110001111000110101111101110101001110101010000110101
100101111100001010001000100100011101010110001100010001011110100101011010111100010010100011000000100011100101110110010101
110000000001100010100010001101000001000000100001000100010000001100010000000001011000101000011010101000001100000011000100
111111111111111111111111111111111111111111111111111111111111111111111111111111111111111111111111111111111111111111111111
