111111111111111111111111111111111111111111111111111111111111111111111111111
000100000010010100000100011000001000111100001000000100011000000010001011001
100101011011000110110101000011101010011001100011110001001110101010101000011
110111001001010011100001110110101111010011101110011111100011101010100010111
100001101101011000111100110110000100011000100111000001111011001011101010001
111101101001011110000111100100110001001110110011111011001000011000111010111
100001001011000011110001001101111111100100011010001000011111111110010010001
101111011011011000011101100111100000110101110010101101110010101011011111011
100001011001001110110100110000101101100111000110100100000110000011000010001
111101001101101100100110010110100101001100011110110111010010111001111010111
100001100100101001101111011100110100011110110010110000011010101100000010001
101111110110111011001100011001100111110000011000011111010010001111111111101
101010000100011010011001110011001100010110111011001000011111101000000001001
100010110111001011000011000110011001010010001011101101111000001101011100011
111010111101100010011111101100110011110111101001001000001011111001000111011
100010000100111111000001001001100110100011001101011010101001000011101100001
101110110110001001111100011101110100001110011001001111101101111110100110101
100100100110101011000111010100100001011100111011101000111000000000110011111
110111101100101001110001110110111011001001110001001010011111111110011000011
100011001001101100100100100010001110011011000111011011001100010011001101001
111000011011101110001110001011100011001011111100001011100101000111100111101
101111110001001011011011111110111001011010001001101000110001011101110001101
101011000101100010000011000000011101110010101101001110011011110000011100001
100000011100111000111110011011110001100110100101111011001000010111001111101
110111110110001101100000111001000111001100110101000001101111000011100100001
100100000011101001001111101100011110011001100100010111001011111110110001111
101111111001001011011010000111110000110011001111110001101001100000011111101
101000011101011001000011110110000101100111101100010100101101001111001100001
100011001001011101111000010100101101101100001001011110100100011101100111011
101111101011010001001011010001100100000101111011010000110001110100110110001
111010100001010111011110010111111110111101000001011010011111100001110100101
110000110111010001000100111110000011100001011101000010111000111100000101111
100110100010010100010101100000101000110111001001101110010010011001111100001
101110101110111111110100110111111110100101111011100111000111010011010111011
101010100010001000010110010100010000101100000010110011111110010110000001001
101000111011101011010111000101010111101001111110010110000100110100110100011
101011100000101001110101111101110101101011000100110100110111110101110111111
101000110111101101000100101101000100001010010001100101110000010100010100011
101010010001101100010110000100011110111011011101001100011111000111110001001
101111111100100111110011010101111000100011000111011111010101111100011101101
100001000001110000011001110101100011110110010001010001000100000001000111101
110111011111010101001101100100101110000100110101000101110101101111110000001
110000000000011111011000001110001000111101100101111101000100100010111111101
100111111110110001001111111111111101101000110100011001011101111010100000101
101101000011100101101100010101010001001010011111001011011000101010001101101
100001011001101100100001000000000111100011010001101011001110001011011101001
111101001100001110111111101111011110001011110100101001100011101001000100011
110001100111111010000000100010010010111110000110101101111000111101010111111
100101110000001011111110101110111000100010111100100100011110010101011100001
101111011111101000000110111000100011101010101001110111010111010001001001101
100110000000101101111100000011111110001010001011000001010101011011011011001
110010111110100100110001111110000010111011101001011101000001011011001011101
111000100100110110000111011000111010101001001101001101011101001001111010001
101111110001110110101100010011110010101011011001101001001101101101000010111
100000010111000100111001010111010110001000001011001111100111101001011110001
101111010001011110010011010100010111011111111001100010110010001100001011101
100010011101001011011110010110110100001100001100111000000110111110100010001
101010110101101011010000110000110101111001011110011111011100100011110110111
111011100001101001011011110111100101001101000111000110010001101001000010001
100011001111001100000011000100001101100001110101110011110111001101111111101
110110011000011001101110011101100100101111100001011000100011100100011000001
110000111011111111111000110100111110111000001101001110001110110101000011101
100111101011000000001011100110000010010011111101100010111000010111111110101
101101101000011111011001001111110111000110000101101111100011010010000000101
100100101111110001001101011100010001111100110100100001001010011011011011101
110110000000010111100001011001011100101101100110101100011011000010001010001
100100110111010001111111000011110001100000110010111001111001111110101110111
101101110001110100000001110111100100101111100110001011101100011000100110001
101100011100100101111101000101001110100100101111101010000111001110110011011
100111000110101111000001101100011011110110100000101000110101100100111001001
110011110010000010011101001101000011000100111011101010100000110101101101101
111000111111101010111001101001111110010110101011001011111111100101100101001
101110000000111110101011001011000100110000101001011110000110001100110100011
100000101010000000100000011000010001111010001100000000110000100110000101000
111111111111111111111111111111111111111111111111111111111111111111111111111
