111111111111111
000000111000101
101110010010101
111011010110101
100001010110101
101101000100101
111101111101101
100000000100101
110111111110101
100010000110101
101110110010101
101100011010001
101001011011101
100011001000000
111111111111111
