111111111111111111111111111111
001001100011000101010001011001
100011001000010100010100000011
111001111010110101000111101111
101100011110010101011100100001
101111000011010111001110111011
101001111010010011101000100001
100011001010111001000010101101
110111101010101101111110100111
100001101010101100000111110001
101101001000100111110001011101
101100011111110000010100000001
100111110000111110111111111101
110100000110011000111000100001
110101111111000010010011101111
100100010001101111000111001001
101111011100101011101100011101
101100011001101000100101110001
101001010011001101101100110101
100011000110011001000110010111
101111111100111100010011010001
100110000101111001111110010101
110010110001010011001100111101
111010111111010111101001101001
100010100000000010001011000011
101010101111111000101001010111
101110111000011111111101110001
100110011011010000010101000101
110011000001000101000000010100
111111111111111111111111111111
