1111111111111111111111111111111111111111111111111111111111111111111111111111111111111111111111111111111111111111111111111111111111
0001000000000001000000010100000001001101000100000001100000000011000100000101011000010110000001100000000100011000110000001100001011
1011111011111100010111000110110101100001101101011100111101010110010101110000000010110000101100111011110101000010000110100110101001
1000110010001111110100010011100100110100001101001110000001011100110100011111111010110111100110000011000101110111111100110110101101
1010011011101000011101111001101110100110111001100011111111111001110111010100001110000001110011111010011101011110000101100000100101
1111010000001011001101001100100010101100100011111000000000100011010000000101100011101100011000100011001001010000110001001111110001
1101011111101011100101101110111010100111101111001011111010101111011111110101111000111101001110111110011011010110011011111001011101
1001001000111010110001001010001010110100000110011000010010101000001000011101011110001001101010000011110010010011111110001100011001
1011100010000010011111100010100010010001111100111111110110101010101011001001000011101111000011111010000110110110000000100111001011
1000111111111111000000101011111111011011000001100000010110101011101111011011110110000010010111000010111100110011011111110011100001
1110000000000000011110001001000001001000010111111101010011101000101000010010000011111011111100011010001110011000010001011000110101
1100101111110101111011111101111101101110110011000001011001001110100011110111011001000010000101111011100011001111110100001110011101
1001101000010111000000010101000100100010011110011111010011011100110110000100001101011110110101001000111001100000010111011011000111
1111111011000110010111000100010110111010110000110010010111000101111100111101100111001100010001011110011101001011011110001001110001
1100000011111100110001010111110010101011100111100110110000010000010001100100111100011001011111000011010001011010000010101011011101
1001111110001001111101111100011000101010001100001110100111111101110111110001100001110011010001101110010111110010111010100000001001
1011011000111011001101000001111110001000111001011000111100011000110110000100110111100110010100101000110010000111100010111110101011
1010010010011001100100011100110011101111101101010011100001001110010010111110100101001111000110100010011011011101001110000011101011
1011000111001101110111110110011001001000000001010110001111100011111010101010101100011011011100110111110010010101011011101000111001
1010010101100001000001000011001011011111101111010000111000111001000010100010100111111010001110100001100110110100010000111010001101
1011110000111011101100011001100000000001101010011111101101101100011110110110110011000010100100101011001110100001110110011011100101
1000011111110001000111111100111111011101001010110001000000101111110010010010111010011011110101101110011000111011010111001110001101
1101001000011101110100010001110001110000011010111100011110100000000111011010100010110000111101100110111011110000010011100000100101
1001100011001000000101011100100100100111111010011001110100110111110001001010001110011110011001001100110010011111011001111110111101
1011111111101111011101000101101110111100101011000011000101100100010111101011111000110011010011111001100110110011011101000100100001
1000110001001100010001110111001010001110000011111010010101001111010011000010011010011000010110100011001110000110010000010111101101
1110000101011001110111010000011011101000110110001110110001011010011001111011010011001101110000001010011010101100111011110010001001
1011111101001100110011011111110001001011110100100100111111011000111100101000010111100100100101011010111010100001110001100110111011
1000100001100110011001001100000101011000010001110101100000010010000110001111010001110110101111110000100010111111000111001110100001
1010101111110011111101100001111101011111111011100100110111110110110000111000011111000100111000110111101010110100010001011010111111
1011101100011000001100111101001001001000110000101101110000111111111011100011110001011110100010011100001010000101111111000010100001
1000100001011110100110011000011011100010011110100000100110100000110001101110010100010010001011001101111111110100100011101010001101
1101111111000110110011001111111000111111000100101110111100101101100100100011000111111011111111100100000000010111101000101010101101
1000010001110100011111100001000010001101110111111000001001100100110110111001101100001001010110110101110111110110001110101111100101
1011000111100101001000111101101011100100010001010011101100110110010111110011000111100011000100010100100100000000101000101000111101
1001101100001101101010000100101110110001011100010110100110100011011100010110010001101111010001010110101101011111111011101010000001
1100111001111100111011011110100100011111010111011110110110001110011001000011111100100101011011010011100001110000110010001011111101
1001100011100110001001001010110101110001000101001000010011111000110011111110001110110000001001011011001011000110011011101010100001
1011101110110111011101100000100101100101010001101011111000100010010111000000100110111011111101001001111001011111010000001010101111
1000101010010001001100111111101100001111011111001000101110101110110001101011110010001000011001101100011101001000010111011010100001
1101100011000101100110010001101110111010010001101110001000100110011100101010011011101011110011000111001111101101111100010010111011
1000001001101100110011000111001000100000110100100111011011110011000110101011010010001010000111111101100100001000101111110110000001
1111111101001001111001010110011011101111100110110010010011011001110110111001000110111110110100100000110110111110100000010011011111
1000001101111011110011110100110001000001001100011010110110001100100010001101011110100000100001101110010000100000111011011001001101
1101100100100010100110100101110100011101011001000010100010100110111011100001010100101011111111001010111111110111110010001101100101
1001110110001110001110001100100101111001011111011010001000110100010000111111010001101001000000011010000010000110000111100101110001
1011000011111100111000111110101100001101000011001111111111110101011011100011011011101011011111110010111010111100110100110001011011
1001101000100001100011101000111111100111011001111000110001010111001110001001001000111010010000010111110010001001111110111111000001
1100111110101101101110001010011001110011111100010010011100010001101000111101101010001010110111000001100111101011000010000001101111
1110010000100101000111011011001101000110001001010111000101111100100010011000101111101010011110011101001111001000011011010101001001
1111010111110111011100000001101100010010101111010011110100000110110111110010100010001011001100110001011010011101111001010111011101
1111010000100110010001111111001001111110100001011010010111101110011100000110111011011001100111110101001010111001101101010001001001
1110011110110100110111100011011101101000111100011011010010000011000101011100101000001100110100000101101000101100101101011011101011
1100110010000101110110001000010100001010100111001001011011011011110101110101101111111110000101110111001010100110101001011001001001
1001111011101101000100111111110110111011110100011101010010001110000100010000100110101010111100010110011011110000001011010011011101
1011011000101001011101101101010110011001110001110001010110100100111101010110110100001000001111010100111001000111111010010111010101
1011000010001011001101100101000011001100100100100111010110110101100101011110000001101011111010011101101101011110100010110001000101
1001101111111011100100110001011001101110101111101100010010011101110101001010111011001010110000110000101001000010101110010111110001
1100111100001001110110100100011100000010100011001111011011010000010001101000011110011000100101100110101011101000100111010011010111
1110010101101101011110101111110111111110111110011010001011000111010111101101001100111110101101001110101000101101110010011000010011
1011010001001000011000100110000101000010010000111000101001111100010000100101100111110000101001011000101110111000111010111010111001
1010010111011011110011110100110001011000110111100011101100001101111110110111111100000111101011010011101010001110101011110010011101
1000110001000001100110000101111101011101110100001001111111100100001000010010110001111110001110010110000010100110001000011111000001
1101111011111111001100111111000101010001000101011101000000110111101111111000100101100010100100110000111011110011111111000011111111
1001010010000001011101100010010001010111011111001111011110110001100000011110101111001000110101111111110001111000100011011001100001
1100010111011100000100111000110111010110010011100001000100011100111110110000101010011111110100010001100100101110001001111100001101
1111010010001111010101100010011100011100111001001101110111000110010000011010101000111000010101000100111110001011111100001001111001
1100011011100001110100001111001101001001111100011000100101010011011011010011101011100011000111111110000011111000001111101100110011
1001011000110100110111111001100101101011010001110010101100011000010011011010001000110111110011000011101011000011100000100101100111
1011001110011110100101011101110101111011000100011010101111111111111110001010111111100100111001111010101110011110111101110100101101
1011111011001000101101000001000100001001111111001010100000010000100010100010000100001110001100000010100000110000101100010101100001
1010000001101011101001010111011111011100110001101010111111010110001011110111110001111011011111111000111111100110001001110100110111
1000111101001001101101010011011000001110000101101010010011010011111000100010011111011000001100011110001000101111011011100110010001
1011100100011101001000011000001010100011111100101011011001011000101110111011001100010010100001000011101110000100011000101111110101
1001001111111001011011110011111011111110001110101001001101000010000110100011101001000110111111011111000011010101110010101000011101
1101100000100011010000111110001001000000111000101101101001011111110010110110001011111110001000010001111001011100010110100011010001
1000101010001110011101100000101101011110000011111101100011110000011010010000101001000011101101110100001101111001010010110110011011
1110111010111000110100101111100001000111111110010001001011000101001111010101111100011000100111000111011000010011011010111100110001
1010001111100010100110100001111111110100001011000111011110011111100111011111000111001101110110010001001111010110001010011001111101
1011100111001110110010111101000001010101100010010011010100110001110010011000010001100111000100110101101000010110101011010011100001
1001110010011011111000100100011101000100110110111010000101100100011000110011111100110010010101111111101011110010111001110110001101
1011011000110001100011101111110100011111100010101011110101001111001111100110000110011010111101110000001000011110011100000111011001
1010001111100100110110000100000111110001111010001001000100011001100110001100110011000010011000100111111111000011001111111100011011
1000101010101110000100110001010000000100100010111101110111111100110000111101111001111110110011101100000001111001101010100001110001
1101100010001011111101111011111111011110110110010100011101100110111111110000010011001000100110100110111100001101000010001100100101
1000110110111000010000101000100011110000000011000111000000110000000000011011110111101011101110110100100110111100011011111110111111
1101110100100011011011100011101000010101111111101101111110000111011011110011000110001001101000010001110010000111110011000010110001
1001100101101010001110001111001111011100110000100000001011111101001110000110010011011100101011111111000111101100100110011010000101
1011001101111011100110111000011001000101100101111111101000000001011000111110111011000110001010000000010101100001101110111011111101
1010011100010010110010000011110011110111001100000011001011101101000011100010001001101111111000111011110100101011001000101001000001
1011110111000110111011111000100110100100011111111010011011001101111110001011101100001000000011100011000110111010011101101100011101
1000100001111100000010001010110100101101111000000010111110011000010011101011000111111011111110110110011100011000110001000111110101
1010001101100001111110101110100001100000001101011110100011110011000111001010010100001010000000100110111001001111100111010000000001
1011101100101111101000100100001100101111111001110000101000010111110010011010110101100010101101101100010011100011001100010101111111
1000100111101010000011110111111111111100001011000111101111000100011000111010111100111111111100100111011000110110011111111101001101
1110110100001000111110010100001010000101100010011100000001111101001111110010001110100011000110110001001111110100110110000100011001
1000010001111010010000110110100000110100111010110001011101000101101000011011101000001010010000010101100100010001100010110111000011
1011111111010011010110010110111010100110001110011111000101010100100011001010100011111000111111110101110001000101001000010011101001
1000110001000110010111010010100011101111100100110001110101110110110111111010111111011101100000010100111111111111011111111000101101
1010010111011100110001111010111111000011001101100100010100100010010101100000110001010001001111010110000000000001000100011010111111
1111010010010001110101100010010001111010011101001111010110111011010100001101100101000111011100010111111111111011101101010010000001
1101011000110111100100101111000100100000111001011001011100001010010001111111001101101110010101110011001101001000000101011111111101
1001001010100110001110101001101110110110100011001101001111101010111011000100011100111000110100111001100000011111111101000100000101
1011101111101100111100101100111000011100101110011001101000001000001111010101110110011101100110011100111011001010000001110001010001
1000001000001111100001101110011011000101100111001100100011011111100100010001000011010001001111010110011001100010111111011111111011
1011111011111000001101000111001111010111110001100101111110010000110101111111011111010101100001010111001100110110110110000011100001
1010000010001110111101011101100110010000111100110100000110110110011101011000001000010101101111010101101001100010010010111001001111
1010101010100110010101000101110000110110000110000101110010110011010001000011101011110100100001000100000011001111011000001101011101
1011101111110011010001110101000111111110110111111100011000011011011011111110001001010110111011110111111111011001001011101101010001
1001100001011000010111100100010100000100100100001101001011110010010010000111011100010010011000010000011000001101101110000100010111
1101001101010010110001001111111101110111101101100111101111000111011000110011010111011011001011011101001110101000100110111111110001
1101011001010110111101011000110001100100001001110010100100010101010011111001000001001111101111000111100011100010110100000011011011
1001110011010010100001000010000101001110111011011010001101111100010110001101010101100110001000010010111000111110010101111000001011
1011100110000110101101111111111111011010000000001000111001001001110000111001010111110010101101111000011101100011010111011111101001
1010001111111100111001000110000010010010111111101111101011011011011011100011010011011010101100001101110001001000010001000100001101
1011011000000001110011010000110110111010010001000101001001000001010001101010011000001011100110100111000111111110110101110001111101
1000011011011111000110011111110010101000110101110000011101011101000101001110111101101001110100110110010110100011100101100101000001
1111110010010001101100110000011000101010100100011101001001110001011111011100011001111100010110011100111100001001111100101111011011
1100011110110100100101111111001111100011101111001001111011100101001010010001001100000111000110111001101001111100001110101010001001
1001000110010110111100110001101000001001101101101011000011001111111000110111100111010011111100100011000011000110100000101000111101
1011010000110110001001100100001011111101001000101110011110011010000011100011110100011010000001101110011110010110111111101110000101
1001111111100011101011001111101001100111011010101100110110110000101110111001011101111010111100101011011000110011100000100011110101
1100001000001110001010011000101100001100010010100101110010011011101010001111000100100010010110001000001011111001001101111000111101
1110100011111000111010110010001101111101110111110100011011001000101000100000010110101011000011111011101011001100011100001110011001
1100111111000011100010010111111001000001000001010101001001101101101101110101110000101111111011000011001001101111110101011011001011
1001110001011001001111010001000011011111011100010101101011101101001001011100111110111000001001110110011100101000000101000001101001
1011100101001111011100011101111110010110010101110111001010100101011100000110100010010011101101100110110110001111110101111111101101
1010001101100110000001110101000110110011010100100001011000110111010101110011101011110110101000111100100011101000110101100010000101
1000101000110000110101000000010000011000000110001100010010000000010000011000001000000000100010000001101000000010000100001000110000
1111111111111111111111111111111111111111111111111111111111111111111111111111111111111111111111111111111111111111111111111111111111
