1111111111111111111111111111111111111111
0000011001000110010101010100011000110101
1111001100010010110000010001000010000101
1001101111011000110101011011011111010101
1011101010001110000101001110011000010101
1011000010111011111101100011110011110001
1001111010001000100100110110000110011011
1100010010100010110110100100111110111001
1001010111111110010110110001101010001101
1011010111000011010010011111000010100101
1001010010011011011011011010011000110001
1011011010111001011001001010111111111111
1010001010010011000011101000101000000001
1010101011011001110110101111100011111011
1010111010001111010000100001101110010001
1010100010101000011110111100100000110101
1010101110100011000000010110001010010111
1110101000111111111111010111111111010011
1000101011100100001100000100001100011001
1011101001110101100110101101100101111101
1000101100000100110011111001110111000001
1101101111111110011001000011010110010101
1000100000000111001101101110000010111101
1010111111110001100100100100111010101001
1110001000011011110110110111100010001011
1100100011001001000100100000111011101111
1001110111111101101110110110001001000001
1011000100000001000100100011101101110101
1001111101111111110101101110001000010101
1101000000011010000101000010111011010101
1001011111110000111101110110101111010101
1011000110100111100100111100100110011101
1001110000001110001110000001110100110001
1100011111111100100011111111100101111011
1001110100001001111110100010110100100001
1100000101100011100000001010000110111011
1001101100111000110110101110101110001001
1101100110101110000010111000101011101101
1000110000000010101010000010100000000000
1111111111111111111111111111111111111111
