111111111111111111111111111111111111111111111111111111111111111111111111111
000100100000000000100000010010000010101000101000000110000000000111000110111
100110001111110110110111011000111010001010001011110000111111010010010010011
101111011100011100100100011101110011011011100000111111110000011000111011001
101100010001001001101110110001100110000001111111100100000111111111110001101
100110110111101101000010110111001111110100000011001101111101010000100101101
110110100010100101111010100100011100011111111001011101000100000110001100001
100010001000110100100010001101110001010001001100010001010001011111111111101
111011111011100110101111111100110111000101100110110111011111110000010101001
101010001010001100100010000110010010010100110000010011110000100111010001011
100000101110111001111010110011011011111110011111011000011010001100010111011
111111101100101011010010100111001001000111000011111111000010101001010000001
110000100101100010000111101101101100010001101000010001111011101011011111111
100110110001101110101100001000001001011011111111000100001001111010010000001
101111111111001000111001011011111011001011000011111111101100110011110111101
100000001001011010010011010010001001101001011001000011000110010110000100001
101111100011011011011110010110111100111100001101010110011100110100101101101
111100001110010001000011010110010110010111111001010100111001100101111001001
100001100100110111110111010011000011010010011011110101101011101100010011011
110111001101100010100110011011110111011000110010110101100000101111010110001
100100011001001010001100110001100001011101110110010100111110100110010110101
101101111011011110111001110111001101001001000011000110010000110000110011101
101001001011110000100011100110011101101011011110010011011111111101111000111
101100011001100111101000110100111000100001001100110110000001111000001010001
101001001100101110001101100101100011110101100101110011110100110011101111101
101111100110001000100100001101110110000111110100011000000110100110000110001
100010110111111101111111111000011100111100000101111110111110111100111100101
101000010100010001011001100011000001100001101111000010001100001111100001101
101111011101000111010011001011111111001100111000011011011001100110001111001
100010010001111100000110011001100001100110010011111001110011110100111010011
101110110111000110110011001111001011110010110110101100010110110101101000111
100110000100010110011001100110011001111011100100000111011100010001101011101
110011111101010011001101110010111100110001101101011101001111011111001010101
111010010111011001100111011010100110100100100101000001100011000000011010001
101011000001001100110110010010110100101110110111011011111001111101000011011
101001101100011110110000110110110001101110010011001000011101000111011011001
101100001111111010100101100100100111000100111010011110110100010011110001101
100110111000000010101101101101110101110101110010110110100111111000100100001
101111100011101010100100101001010001000100100110000100001100011110111111101
101111001111001010101110101011011101111110101111011101101111000010100001101
100110011100011010100010001011000000000110000010010001000001101110101100101
110100110001110010111111101001111111010010111011010111011100001000101110101
100101100111100110000111001101100011011011100001110100000111111011100110101
101101001101001111110010011100101001110001111101100101110010000010001100101
101101011000011000011011010110001100010100001100001100011110101010111001101
101001011101000010110010000011111101011111100111111101001000111010001011101
100011000111111010011010111110001001000001110110001001111011110011011010101
101111110010001011010010001000101111011100010010101111000010000110010010101
101100011000101110010110101010100001010111011000100011101110111110110110001
101001011110100010110100111010110101000101001111111010001000011000010100111
100011000011111010100101110011111101110001100010101011101101001011110101101
110111111001100010101101010110000100111101111010001000100111011010010100101
111100011111001110101100010100110110101000010010101110110011001000110110001
100001000110011010100111010001100100001101010110100000011001101010010011101
111011110100111010110011011111001111100111010111111111001100111111011001111
100010110101101000011001000100011000110001110010000011100110001100001100011
110110000001000011001101011101111101111100111010111010110111100001111111001
100010111111011111101101001001001101100110001000110010010001001111101001101
101011100010010000111001011011100101001111101111100111011101011000100011001
101001001011010110010011001010110000011000100010001101000101000010110111101
101100011001000100110111111010010110110010111000111001010001101010010110101
100111111101111111100101100011000010000110101111100011011111111111010010001
110101000001100011001100001110011110110100000000001110010000000110011010111
100001011100101001011111011011110000100111110110100100110111010010110010011
111101000110101100001100010001000111111100100011111101100011111010010111001
100001101110101111111001110100011100000110001010000001001000100011010011101
110111100100101010001011100111001101110011111110111111101110101110011010001
100010110101101000101000110011100101011000000000100011000100100110110010101
101010010111001101101110011000110101001111111111101001110101110010000110111
111010110100011001000011011110010100011010101000101101000101011011110110011
110010010001110011111011000011010111001000001110001001011101011000100011001
100111011111000110001001111010011101100011100011011101011001001110111111101
110001010000011110101100011011000000111110111010010001110011100100000010001
100100000101010000100001000010010110000000000000110100000111110001101000100
111111111111111111111111111111111111111111111111111111111111111111111111111
