11111111111111111111111111111111111111111111111111111111111111111
00010100000000001000010001000001100010011000000100010001000011111
10110001111101101101010100010111001000110011110101000101011001111
10100101010101100101011111110110011010000110000101111101011100111
10101100010100110001001000110000110010101100101100011000010110011
10111111000110111111100010010111110110100111101111001111110011001
10010010010110100011111111011100010111110001000001101000100111101
11010110111100101001000110011001010011011101111100001010001100001
10010010110001101011010011001011011001000100001110111010100101111
11011000011011001110011001100010001100011111100011100010101100001
10011011001010011100111100111111100111001000101001001110100111101
10110001101011010001100110100000110011101101111101100100110001001
10100100111010010111001100001110011001100000110100111101111111011
10110110010010110010011111100111111100111110100110100001100000001
10011110110110011010110000110000110110010000001110101100110111111
11000011100100111000100110011010000011010101101000100101100100001
11111000001110100011101111001110101111011100111011110111001111011
10101111111010001001101001100011100101000111100010100001011010001
10100001100010111111001100111000110001110000101110101101010000101
10101100001000001100011110101110100100011110101000001101011101101
10000101111111111001110000100010101101010110001110111001001001001
11111101000000010011100110101010101001010011111100100011100011011
11000111011111011010110100101000111011011000010001101111111111001
10010100010001001010010101101111110010001101010111100001001001101
10110001110101101011000100000000000111100111000000110101100011001
10111111000101100011111101111111111100110001010101110101001110011
10100010010100001110000111000000000110011101111111000101011100111
10101110111111011000101110011011110111010100001100010100001001101
10100000110001111011100011001001000100010111100110111111101011101
10110101100100101010101001101101101101000000110000100011001000001
10100111001110001010111101101100100001011111111101101001101111101
10111100011011100010011001000110111101110000100100101100101010101
10100001110001111111001011110110000111000110001101100110111000001
10001111000100110001101000110011010001101111011000110110100011111
10111100011110010100001110011001111100101001010010010010001111001
10000110110011011101100011011100100110000011000111010111111000011
11110110111000000001111110010110001111111110011111110101000011111
10010000101011111100010000110000100011000100110011000100010110001
11011111100011000111110111111111111110010110100110011101011100101
10010000101110010001100100000010000000110100101100110001111001101
11010101100010110100001101111000111111100110101001100101000011101
11010100111010110110100100001111100100001100101011001100011111001
10010110001010011111111110100000001101111001101010011111111000011
10110111100011010000000110111111111001001011001011011000010011001
10110100111110010111110000010000000011100011101001000011110111101
10100110100010110101011111110101010110101110001101111001000100001
10101110001010100100000010010111111100101000100100011101011111101
10100100101010101111101011010110001001101101110111001111010001001
10110001101110100001101010010100101011000001000001100001000101011
10011111001000111100101000110001101010011111111111111101110101111
11010000011010100110001110111111001000110100001000110100010100111
10010111110010001111111100100100011011110101100010000111011110011
10110100010110100111000101110101110000000100101111010110000011001
10010101110011110010010000000100110111011110111000010011111001101
11010100111000011110111111111110100001110000011011110110001101001
10010110001111001100011000000110101111000111110010000100100100011
10110110100011101001010011110000101011011110010110111101101111001
10000100111000100011110111011111101010010011010011100000101001101
10111110101110111111100101000010000010111001011000001111100011101
10001100000100010001001100011000101010011100001111111100101011001
11100111110101010101011111111111111111000110100011000001101000011
10110000110101000101000000001000010001110010111001111011111111111
10011010011101111101111111100010110100011010101100010000110100011
11000011000001000000000000101010000101000000100001000110000001000
11111111111111111111111111111111111111111111111111111111111111111
