11111111111111111111111111111111111111111111111111111111111111111111111111111111111111111111111111111111111111111111111111111111111111111111
00000000001000011000100000110000000101100000000011000010000000000100010001010110100001100001000110011000110000110101000100010000010001000001
10011111101011000010111010000111110101001111111010011010111111110001000111000010001100001100010000110010000110000100010001011101000101101101
11110011001001111110001111101101010001011000100010111110011000100101111110011000111111111110110101100111101111110110111011000111010100101101
10100110011011001011100010001000011101000011101000011000110010101101000100111111110001000010011101001100100001000011100011110100011110100111
10001100110001100000111000111101110001111001001111010011100110101001010001100000000101110111000101011110111101101000101110010001111000110011
11101101100101111110001111100001100111001101011100010110001111101011011111101011010100110001110101010110000100111110100110111111001101111001
11001001001100000100100100001111001101100001000111110000100101001011010000001001111110000101010111010000101110010000110010000000011001001101
10011011101110110101110001101000011100101111110010000111111100011001010111011011000111010100010000011011101011011110111010101111110011100001
10110010000011100100011011101011110101100110011000111100000001111101011110011001010001111111111111110010100001001100000010100110000110001101
10100110110110001111111010001001100000110011011111110001111111100101000011001100011100000000110001000110110111100101111110110010111110111101
10101110110100101000001011101100111010011000010001100111011000101101111001100101110111111110000100011100010001110111000010011000100011110001
10100011100101101011101000111110001111011110110100101100000010001000011101111100000000110011111111111001011100010001110111001111101001000101
10111011001101111011001010011011100100010000100110101101101011111011110100000111111110011000010100110011000111011100110001101000001101011111
10100010011000001001011011001000110111010111101100100111101110000001100111110110000011010011010001100110010010001110011100001110111001000001
10101110111111100011010001101010010010010100001001110000100010111100001101100000111010011011010101001100111010101011001111100100101011011101
10101010101000111110010111001011011010110101111011100110111000000111111100111111100010111001110100011001101010100001101000110001100010001001
10001010100010010100111100011001010010100100011010110010010011111100000110101001001010101100010111011011000010111100100010011111001111111011
11011000110111000101100001001101010110001111001010011111011110001001110010001011011110101001000001110001111110010110111111000011100011000011
10001101100101110101001111101001000100111001101011000001010000100011011000100011010100100011111111000101100011010000000101111000111000011001
10111000001100011101100010001011111101100011101001101100010111111110011101101001010001101110010000010111001000011011011100011110001011111111
10001111111101000001001011111010110100101000101100001101110010001011001000111111011011001000110101010100011101010001110001000011101110000011
11100011000101111111111001000010010110111101100111111000111010101011101011100001010011100011100111011101010111011111000111111000100010111001
10111000010001000000011101011111000010001101110010001111101000100010101010001101011000111111001110001001110001111000011100010010111000001101
10001111111111011111010001010001110111100100011000100100001111111000001000111101001010110000011100111011100101100011110001011010001111111101
11101000100010000011000101011100110100110101011101110001011100001111101111100001101110000101111001101001001101001111000111010011100010000101
10001010111000101001110101000110000001110111000111011011000001101000100001001100100011011111001101101100011001011100011101000110101110110101
10100010001111101100010111110011101111010001110100001001101111001010111101011110111001110001100100001110111100010101111001111110100110110001
10111111100001111111011100000110001100011100010101101111000001111010000001000011101100100101110110100011101001110100100011011000110010011101
10110000111101010000011001011100111001000111010100100011101100100011111111111000000110001100010100111110001100000110110111000011110111001111
10010110001000000111010011110001100011010001000110111000111001101110011011001110110011111111010001100000100111110010010001101001010101100001
11000011101111110101010111100101101111111011101100010010010011000011001010011011100110001010010111001010110010111011010100001011000100101101
10011110000100011101010001001100101001101010000111011011000111111011100000110001110100101010110001011111111010100001011110111110011101101001
11010110111101000100011101011110100011001000110011001111111101011001101010011100110001101010111111010001100010001101001010000010110000111011
10010010000001110101000101001010111000011111111001100001100000001101001011000110011011000010000010010100110111111001100011111000100110011001
10111011111111000111110101101000011101000000101111110101001111101101011001110011001011011111111011000110010000011011111000010010001111001101
10100000101001011100011101001011110001111111100011000101011000100001011100011001011010001100100010011111011111001000001111011110101001011001
10110110001011000001011001011001000111100000001001101101001010111111000111001100011011100001101111110000010101101101100001000011101100001101
10010111100011111111000011010011011100001111111100100101100010001100010011101111001001111100101000010101010000101000111111011000111110111001
11000100110110000001111111110110010101111001010110110111111111011001011000100011111101000110100011000111110110101111100001110010000010010011
11111101100100101111000000000100110100101100000010010100001101001111011110111000110100010011111111110100011100100001101100011110101011110111
10010101001110101100011111101101110110100001111111000101100001100001110000101110000111111000010000110101001001111100101111000111111000010001
10110000011100100001110000001101000010110111000101110100111011111100011101101011101110001110110110000101101100001110001001110100001111011101
10000111110111101100011011011001011010100000010000010110010000000111001001000000101011101010110111111101001001101011111011000001101100011001
10111110000000111001110001110011001110110111110111010111010111111101101011111010100001100010000100101001011100100010110000011111000101110011
10110000111010001011000111100111101000100001010011110001010110000000101000001010111100101111111110001011000110110110000111111000010001100111
10010111100011101001010110001101001011111101011000110101010000101110101111100010010110000000101100101011110110010100111110001011111101001101
11011110001110101101011100111000011001101100001110000111011111101000100001111111010111110110001001111010000011010101100010101011000101011101
10000000111000101111011001100011001100100001100011010110000011001011111101010001000100110100100011010010101001110000001110101001010111000001
11111111100010101010010011001111101110110100111001111100111110011001000100011101110001100111111110000111101101100111111000101111010011101101
10010001101010101000110110011000000010011110011111000001100000111101110111001100000101001100010000111101111001001100011011100011011000100111
11000100101111101011110011011111111011001100110001011111110111101101000001101001011111011001000111110000110011101101010010001000011110110011
10011110000100001001011010001000011111101001100100001000110110001000011111001011010001010011011101100110100111001001000110111111110100111001
10110011110001111101000011101011000100001111001101100011100100100010110000011111110101010111110001001110101110011011111100110000110001101101
10000111011111100100011110001011110101111000011101111111001111111111100101000101100100010000100101011000101011001001000111100101100111100001
11110001000000110001010010111000100100100011110000100000011010000101001111110101001111110110110100001010101001101100010000110100001100001101
10011101111110011011111000011101101110001110011111101011111010110000011000100000011000100010011111111010101100101111111110011101101111111001
11000100100011010010110011000101000111111000110000001110001000011111110010111101010010111111000100010011101110001000000011001111000000000011
10010110001001000110010111101101011100000011110111100110100010111000100110110001110110000011010101011010000110111111011011100001111111111001
11011111111101110111000100100101011001011001010001111100111111100010001110011011100011111001010101001000111100000100011010111100100011011101
10011000010101100100011101110001000011001100011100000101100011001111111011001010001110001101110001101101100101010001010000000110111000010001
10110011000001001101110000011111111111101111001111110101001010011000000001101110111011011100011111100100110101111111111110110010001101110111
10110111111111011000000111110000000010000001100000010001011110110010111111100000100001010111001000110101100000110000010000011111100100100101
10100100000001001011111100000111111011110111111010111111011000011010011000111111101100000001100010000100101111100111011111001100110110001101
10001101111101101111000001111101100000011100000011100010001101110011001010000010000111101101111111111110111100001101000011100001100100101001
10111000100100100001011111010000111111010001111001001000100101100111100010101110110010100100001100100010000001111001111000101111001101111101
10101110101110111100010000000110010110000111011101111011110100101110111111101000011010110110100110001011111111011101001110111000011100011001
10001010101010101111110111111111000000110100000000001001010110100000000001101011111000010011110110101000000110000000011010011011110111010011
11101000100010000000100100001111111010011111111111101100010010111011111100100010001111011001100011101011010010111110111011001010000110000111
10001011101011111110101101100110001111110000000110100101111010001001000111111010100011011101001001111110011010000010010011101010110011110101
11011001111000000100100100110010100011000111110100110100100011101111010000001110111001001001011101000011110011110111000110001010111001000101
10001100011101111101101110011000110110011101010101100101101110001100011111100000011101101011110101101000011000010001101100111010011111011101
11101111000100100001100011001111100100111001000100101101001000111001111000111011010001001000000100101110110011011101100101101011000110010101
10101011110110101100111001011000001101100011011110101111011011100011000010001001110111111010110110001000100110011001001100000011010000110001
10101000010000100110011101001101011001001001001010001000001000001010011011101101100100001110100111111010001100110011011111111110011111111011
10001101111101110011110001100111000011011101101000111110111111111110111110101111001101100011101100001110100110110111001100010100110000010001
11011000100000011010000111110001111111000101001010010100010000000100101100101000011101111001101101100011110011100101011001010001110101010101
10010010001110110000111100011100110001010111011111000101110111110101100001101110110101001100100000101000110110001101000011010111000111010111
11010111111000011111101001000110011100010001000101110101000000110100110111100110110101100110101111111010011100111001110111110011101110010001
10011110001101000100000011010011000111111101110100000100011110100110100000110010010100110010111000011111011001110011010000011000001010111101
10110000100111110111111110011001110100000001000101011111000011101110111010011011000110110110011011000010010011000110011111001111111000101001
10010111110000010000010000111101010110111111011111000001101110001000110011001010010100010011010011111000110111101110110001101100001011100011
11010100011111011101000111101100010100100011000011111100111000101010100111101011010001000110010110001101110110100000011011000001101010001001
10000101011001000111111110000110110110101001111001101110000011101011101110001001110111110010110110100001000100001101000011111111100010111101
11111101001101110010001000110010100100101100001100100111111110101000101000111100110100011010110011111111011101111001101001010000111110100001
10100001100000011010111011111000101101100111011110110000110000101110101101100110010101011010011000010000010000110011111111000110100010111101
10001111110111111010110001011111100100110011000010111011100110100010100100001111010101001011011101110111111110010111000011010011101010000111
10111000010001000010100100010000110101111001101010010000001100001110110111101111010101101110010100000011000011010001011000011010001010110001
10011010111100011110001101110110000101101100101111011011111101011000100011000110010100100010110001110110011001011101001111110010111010011011
11001110001111011011111001000111111101000110100011001001000111011011101010010010111110111010111111100000111101001101101001000110101000110001
11100011100001110000001101011101000000011100101001101100010011001010001011111010100010010010011000111111110101100100101101011100101111100101
10111001110100100111100111010001011101001101111100100111111001111010111000001010001011010111000010010000010100110110100001000001100000101101
10001100011110001101110011010111010001011000011001110110001011000010001111101011111000010001111111010101000110100010111101111111001101100101
10100111000010111100011010010100010111110011110011110100100010010111011000101111001111111101000011010101110110101011100100100001101000110111
10111101111000100001001000110101110011000110110111100101110110111100010010100000011100010100011010010100011100111000001110001101001111110011
10000000001111111111101111100000111001101100100001001100011100101001110110111011011001000111111000110111001001110010111111111001011000011001
10111111100010000001101010110111101100000110101101011111110001101011000010001011110011101100001111111110011011000110010100001101010011001101
10100000101010110100000010100100001111111100100111010000000111001001111111101010000110100001111000000010110001101111000101100001010111101001
10101111101000111111101000101110100100000001110001010111111101101100110001001000111100110101000010111000100111001111101100111111010110000011
10100011001010100000111111101010110101110100111011000100000001100110010101101111110101110101011110101110101101100110100110001010010011011001
10101010011111101110000001001000010100011110001001111111111101001111010100001100000000010111000010100000101000110100110011100000111001111011
10111010110001000010111011011011010111011000111100011010000100011111010111111001101111010001101110101111101010000001111000111110011100100001
10000010110100011111100001011011010000010011100001001000110001000110010110001011101000011011000100100100101111111111011101100011000110111111
11111110000101111000110101010001011011111111001111101011111111011100110100101010101111001010010101110110100101000001000000101111110110100001
10000011111111000010000101010111011110000010011011001001000100010001100101100000100010011000110100010000110001011101101010100001000010001101
11011000001000011110111111010001000010101010110010011101010111110111110000111111111011001111111111011110011101010101001010101101011111111001
10011111101011010000010001011011111000111010110110110001010000000101011111110000000010011000011001000100110001010001011011100100010000011101
10110001101001111111010100010010001011100010010010010101011111111100001000000111111110110011000011110110100111010111001000110111111101010001
10000101000011100011110111110111011110001011011011000101000011000110100011111110000010010111111010110011101100010101101010110100010001010111
11101101101110101001100100010101000110111001010001111101111001110010111110001000110111000100001010011011001110110000111010000101010111010001
11000100100110101100101101010100010100101101011011000101001100011000100000100010011101111110111011001010011010111110001010111101000100011101
10010110110010101110001101000110110101101101001000011100011111001101101111111111001000000000110011101000110000100011101110010001101111110001
11111110011010001011111001011110100100101001101110111001110001101000100110000001100011010111100110001111111011101000100111000100111000010111
10000000110010111001100011000010101110100011100110100011000100101110110010111100001011011100001111011100011000111101110101111110100011010001
10101111100110100011001111111010111000111110110010001110010110100010011010110111111110001001111010000001110010000100110001100010101110011011
10111000101100101110011000110010100010100000111011111000110010111011011010000011000011101011100000101100100111110110011100110110101000110001
10001110000101101000110010011000101110101110001001100011111110101000010011111110011010001000111110100110101101000111000110110000101101100101
10100111010101100010011011001110100011101011101101001011000010001111110110001100110011011110000011101111100101011101010010011111100100001101
10110001110100111111001001100111111001100000100101011110011010111000110010101001100110010011101000100000110001001000010111001000110111111101
11111100011110000001111100110000001100001111101101001100110010110010011010100011001110111010111110111101111101101010110101100010010100011001
11000111000011111100011110111111101110111000100101011001111010100111001000101110011010100010011010000100001001001110100001111111010110110011
10010011101011000111001000100000100011110010110100010011010010001101100011100100110010001011010011110111100011011000101111000001000100000111
10111000111000010011100011101011111000100110010111110110010111011000111110111101111011111010000110110001111010010011101000011011111101111101
10011010010010111000111110001110001110001111000110000011010101010010000010100001000000010011011100011100001010111001111010111001100001000001
11001111010111101110001100101100101011111011110010111111000101011110111010101011011101110110010001000111101110111100010011110011001111111101
11101100011110000011011001111001100001011000011010100001101101000100100010101110001000100100110111101110100110010111010110000110011100010001
10001001111000101001010011010011110111000011001010101100101001010001101110101100101110101110010001000000110011010110010010111110110001000101
10101100000011111100010111010110010110011111100010000110101100011101000000100111100011100011011011011110011001010000111010110000111011101101
10100111111010010111010001010000110000110000111111111110100111110001111110110011001001101000011001000011001100010101100010000111100010100111
10110100001111010001010101011110111111100110000000110100110000011011100011111010011100001101110011111001100111110101001111111110001110110011
11110101100001000101010100001010010000110011111110000101111101001110001000101010111111111111000110101101110000111101011000001010101010011001
10000101110101111100000111101011011010000111000011110101000111100000111110000010101000010110011100000100011110000001001010101000111000111101
10110100011100001111110100000001001011011100011010010101010000111101100011101010001110110000110001011111000011110111101110101010001101111001
10100111001111101000010111111111101110001101011011000101011110000101001001001111100000100111111011001101111000110010101000101110100101010011
10101101100100100011011110000000100100100001110011011101000011110111011101111000111110101100011011011000101110011000101101100111110100000111
10100000110110111110010000111011110101111101000110011001111010010001010101100010000110101001110010001010100011001010100101110011000101111101
10111111110110100100110111101000110111000111011111010011000011011100010100101111110011101101100111100010111001101111110001011000011101000101
10100010000010001101100011001010100010010110010110010110010110000111110110001000111000101101001100111110100011100001011101001111110001010001
10001000101000100100001000011010001000110000110000110000110000110000000010100010001010000000011110000000001000101100000001100000000100010100
11111111111111111111111111111111111111111111111111111111111111111111111111111111111111111111111111111111111111111111111111111111111111111111
