111111111111111111111111111111111111111111111111111111111111111111111111111111111111111111111111111111111
000100010101000000000001101000100010001010000000100100000001100010101010101010000101010001000111000000011
101111000101011101111011000010001000100011101110110001111100001010001010000000101100000101010010010111001
100010010101010001100010011111111111111001000010000111000111111000101000111101111001101101011011110011011
111000110100010111001110110010100001011101101011111100011100011111101011101101000011001000011000111010001
101111110110110100011000111000101100000100111001010001110001000101101011001001011111011111110010000010111
100000000100010101110011101101100110110110001101010101000111110000001001101011010001001100010111111110011
101111111111010100110110000000110011100011011001000100011100010111111100101010010101101001011100000011001
101000010001110110000100111010011001101001001011101111110101011110000110001000110100100011000101111001111
101011010101100011111111110011011100101011101000101000100001001100110011101111100111111111110100001100001
100010000100001110000000000110001110101000101110101010001111100101111011001100001100000000110110111111011
111111111111111000111111101111111000101110100000101011011100110100100001100111011101111110010010011001001
101010100100000011100001001000100011100111111111101111010110100110110100110001000100010011010111010011101
101000001101111000101101011010001110110001100000100100010010001100011110111100010111010110000100010111001
100011011000001110001001110011111000011100001011110101111000111101001010010111110100010000101101110001011
101110010010100010101011000110001101000111111000100100101011110001101011010001100101010111111000000101001
101010110111111110111011011100100111110000101110101110100001100101001001011101001101111100011011111111101
100010000110000110100010010001110001100110000010001000111100101101011101001001011100000001001000100001101
111111111100110011101110111011011011001111101111111011110110111001001001100011010111101111101101101100101
100000000001111000100010001001011001100001101000000010000110011011101100001010010100111000000100100110001
110111111111101110110111101101001100111101001011011110110011001110000111011010110001100011111110110011101
100101000100101010000110100101100110001101011001001010111111100110110001110010000111001011000100111001101
101100010001100011110000110100110010100101001011101000010001110010010100011010111100011010010001101100111
101111011011001000111101110110111011110101100010001011000100011011111101001110011001110010111111000110001
100001001000011010000100100100011001100111001010111011111111001010000111101000110011000110110001101111011
101101011111111110101110101101001100110001101110001110000001101011010001100011100111111110100101100010001
101001000110000010100000101111101110011101000111100100111011101000011011001001001100000010001100001010101
101011101100101011111110100001000011000001010000110001101000101111110010011111011001111011111110111110101
101011000101101000000010111101011010011111111110111111001110101101010110110001011011001000001010100000101
111010011101111111111010010101010011011000100010101001100010100000010011110101010001101110111000101110111
110010111000110000001011000101010110000010111010001100001010111011111010000101000111001100110010101010011
100111101011100110111001101101110011111110001000100110101010010000101011011101110100011001100111101011001
101100001000111110011100111001000110000011101101110010111111011110100010001100010001001011101101101001101
101001101110000011000110010011011100110111000111011000110000010000101110100111011011111010100001001101101
100011000011111001010010110110010001110010010110001111100111111011101000110010001110001000110111011100001
101111111000001101111010100111000100011011110000100000001100101000101101111011101100101010000100011001111
101101001110111000001010001101110111001000011111111111111001100010100111001010000101101110110101110011101
100000011010011111101011111000010011111010110001000000001101001010110011100010110001000111100100010110001
111111010011001000101010011101010110001010010100011011011100011010111010110111110101010000111101010010101
100001010111100010100011001101011100101011010111110001110001111110010000010000011111111110011001011000101
110111010000110110111001100001001101101110011100010101000111000011000111011111000110000111001011011111101
110110011101110100011100111011100001000011010001011100011100010111111100000010010000110001101001010001101
100100111001100111110110010000111111111011010101001101110110110001000111111011011111111011101101010111001
101101101011001110000111010101100001101010010111101001100100010111010011000001001000010011001001010000011
100101100001011100101100010101101011001010110010101100110101110011011001111101011011000110011011010111111
110100101101011001101001111101001001011010111000100110100100011001011100010001010011101110111110010100001
100110111001000011001011000001011101000010001110110010101111011100000111011011110110111000100100110110111
101100110011111110011011011011000101010110100000111010001101010111110011010010100100010011110001110010001
100110100111000010110001001001110101110011101111100011100100010000011110011010001101010110111011011010101
101100101101111010111101011101100100011000111000001110001101110111011000110011011111010110000011000010101
101001101000100010010001000100101101011101100011111011011001000101001010100110010000010011101110011110101
101011100010001111010111111110000111010100110110001000010011110101101011110000110111011000001010110000101
101011001010100001010000001110111100010110100010101110110110100100101000100111110001111111111000110111101
100010011111110101011111100100001001110010111000100011100100001110001010111100011100100000101011100010001
101111111100011101000010110101011011000110010011101010001111100011101110010001001110101110001010111010111
101000101001000101111000110111110010010011011001101000100001110111001000110111100010001011101000100010001
100010100011010100001010010010100110111011001100111111110101000001111011110110111010111000101110111111101
111110101111110110101011011000101100100001100111100000011101101100001000000010001010011110100000000001101
101010101000010011101001111110001001110111110100001111001000100111011111111011101011000010110111111100101
100010001011011011001100111011111100010001100001111001101010101110001100011000001001111000011110000110001
110110111010010001011110010011000101011100111111001101001110111000111001001111101100011111010000110111101
100100011010111100000011000110010001001110000101100100011100110011110011100001000111001101010111110010001
110001010010000111111011011100111111100010110000001101111001100110000111111101010001100101010010011011011
100111110111110100011001001101101100101010011101111001001011001111011111000101111111110100011000111010001
101100000101100001001111101001000101101011001111000011100001100011000110010101000010000110110010010011101
101101101100101101101000001011110000111001101000011111001101001001110000110100011010110011100111110110001
100100100110001111100011011000011110100011111011111000011001111100011111110111110010111010001101000110111
110110110011111000111111001111001100101000100010001111111100011001010000010001000110011110111100011100101
100110011110001010010001111101101001101110101110101000000111000011010101011101101111001000000101110001101
110100111000100011000100001001001011100011100110100011110011111110011111001001001011101011111101010111001
100101101011111111111111100011011000111000001100111111011000010100110001011011011000001000011001000100011
110100100010001000101100001001001110101101111001100000011111010101100100010010011011011111010011110111001
100110101110101010100101101011101000000111000011101011010001010101001111110110110001000000010110100001101
101110100100100010110101111110001101010010011111001001110100010100011000000100111111011111010000111101001
100010110001111110010100100000111001111000110110011101000111110101111110111101100011110001010110001101011
110110011111101011010110001111110011101111100011111001011101010001000110110000001000100101110111100100001
100100110000101000010111111100000111000110101000000011001000011111010010011111111110101100110010110111011
110101111010100010110000000001111100010010001101111011100011000110011011011000001010101110011000010001001
100100001010101111111110111011000110111010101101101000111111110000111000010011100010001011001101111101101
101110101110100001100010001010011100011011100100101110001000111111101111110110001011111011100101000001101
111010100100111100101011101010111001001000110110100011100010100101000000011100111010100001110101011111001
100010110110001110001000111010100011101101100110101001111110110100011110111001100000101100010101000010011
101010100010100011111110001010001111001000111100101101010010100101110010000011101111101111000101111011111
101000111011111000010011100011101100011110001101111000000110101100111011101110000110001001111101001000001
101111100000000011011010111111000101110111100101000011111100100110011010001100110100111100000100011010101
100001001111111111001000101000011101010000110101101110000001110011001010111001100101110001110111011110101
101101101000010101100010001111011001010110000100101000111111011011100010011101111101000111010001010000101
100100111011010000111111100001110011010011111110100011101010011010111011000101000001011110011101010111101
110110010001011011100101111101100110011001000110101110000000110000001011110111011111010000111001110100001
100111010101001001001100001100101100111101110100100100111110000111011010010010010100010111101100100111011
110101000111101100011001100110001110000001100001110001101011111100010010111010110001110001000110001110001
100101111110001001110011110011111000111111001111011111001000000001110110101000111011000100010111111100111
101100001010101100100110111000010010100000011000010101100011111100100100001111101010010111010100011001101
101001101010101110101100001110110111111110110011110000101110000111101110100110000010110001110001110011101
101011000010111000000110100010010001000100100110000110000010110000001000110011110110110100110111000110001
101001011010001101110011101011011100010110110100111111101110111111111101111000110100011110010001011110101
101101110011100111011000001011000111110000110001110001000110101000000101101110000101001011110101011000101
101100011110110001001111101001110000111010011011000101110010001101010001000011111101111000100101010011101
100111000000011101011000001100010110000011001110011100110111100101011111011001000100100010111101000111001
110001111011010101000011111110111111111111111000110110010010110111010110011101010101101110000001111100011
111100011001010101111110001011100001000100100011110011011110000110010010110000010100100011111111001001111
101101001101000100011000100000001100010001101110000111001100101100111000011111111110111000001000011011101
100001100101110111010010111111111111111100000010110001100001101101101010110000101000011111101011001011001
101011110001000001000110000000000000000101011000100100101011000001000010000110000011000000100001100000010
111111111111111111111111111111111111111111111111111111111111111111111111111111111111111111111111111111111
