1111111111111111111111111111111111111111111111111111111
0010001000110100001010001000100010000000000000010000101
1011100010000110100000101010101011011110111111011110001
1000110111010011101111100010001001000011100011000011101
1110100001111000001000111111111101011000101001101000101
1000110111101111111010001010100001001110101101111110001
1101100001000010011010100000101111011100100100100011111
1001001101011011010010101111101000010001110110001000011
1011111001011010010110100100001011110100110111111011001
1000000011010000110010101101111001000101100010001001101
1111111110011010100110111001011101010111001110101101101
1010000011001110101100110011010101011100011000101101001
1000101001100100101101100110000101001101110011100111011
1111101100110101100100001100110101101001000110110001001
1100001111100100101111111001110111100011011100011101101
1001111000001110100100000011000000111111000111010101001
1011100011011111110111010111011110110001101110010001101
1000101110000110000110010001110010000101001100110111001
1010001010110011011100111100011011111101100101110011101
1011100010011010010001110111010000000100110100011010001
1010111110111110110111000100010101111110110101010011011
1010100000110100110100010101110101100010000101000110001
1000101110010101100001110100010100001011111111011111011
1110100100110001101011010111011111111010101110010110001
1010110111100111001110000001001000001010000100110000101
1000010000101110011100111111101101101000110101111011101
1101010110100011111001100001101001001111100101101010001
1001111100111000010011101100101011100000101100000010111
1111000001101111010110001110101000111010001111111110001
1100010111000001011100101000001010001111011000100111011
1001110011011101001110111111011011011100000010110100001
1011100110010001100110000001110001000111111110010101111
1000101100110111110011010100010111010100001011000101001
1010101101110000011001011111011110010001101011110101101
1010100101011011111101110001000011011111001000010100101
1010111101001000000100100101111001111000011011000110101
1010000100011111011110101100011100100010111111111100101
1011101111010001001010001111010110110110100000000001101
1000100011000101100011111001000100010011101111111111101
1110111001111100101011010011110111011001101010100000001
1010011100001110101000011000010010001100101000001111011
1011000111011000101111001011011011100110001111100010001
1001110001001011101011101110001000001100111000111110101
1100011101100011001010001000111111111001110010000000101
1001000100111110011000111101110000010011000111111111101
1011110110010100110011110001100101010111101101010011001
1001010111010101100110000111001111010001101000000110011
1101010000010100101100110010011010011101001010110110111
1101011111000110100001100110110010110100011010010010001
1000000001111110101111111100100110100111110011011111101
1111101101000000101000100001110010001100010111000100101
1010000111011111111010101111111011101001010101110001101
1000110011010001010010001000100001100011110100011011101
1010011001000100000110100010001100101000000001001000000
1111111111111111111111111111111111111111111111111111111
