111111111111111111111111111111111111111111111111111111111111111111111111111111111111111111
000101100001010000100000000100001000111000000010011001011000000000000001100001100000110001
100001001100000101101101101101011010010011111011010011000011101111111101001101001101100101
111101101110111111000100111001001011000110000010000110011110111000010001011000011000001101
100100101000010000011110011011100001101110111110101100110110100011000101001011111110111001
101110111010110111111011010010111111000100101100111001100000101111111101101011000111101011
100110100010010010001001000110000001110110100001100011111101100100000000101010010011001001
110000110111111000100011111111101011010010110100101111000001110101111110101010111010011011
110111100000010011111001010000111010011010010110100001011101000101000011101000100010110001
100011001010110110001100010110010000110011010011111100011001011101101111001111101110011101
111001111110000100101001000011000110010110011000000111110011001101000101011100001011010101
101100000111111101101011101111111111010111011101010011000111101001010100001001111000000101
100111110001000101101010111000001101010001000111011010010010001101010101111011100010101101
110100011100010001001010010011100100011101110010001000111010111001110100101000101111111001
100001001111111111101000110110110111011001011011111111111010011100010110001110100101000011
101101100001000001001111100100010010010011011001100000110011000111000011011010110100011111
100111111101110101011000001110111011110110001100101010010111110001111001010010110001111001
110011000100000101001101111010100010000100101110001111010011011101100011010110010100010011
111010010111111111100001000000001111011101100011111101011010001001001110010011011111000111
100010110001100000111111010111111010001111101010000101001000111011011100111001001010010001
101000111100101110010101011101000010100011001000110101101110110010011001111101100011011111
101111100110001011000001001000010110111010011011100100101000100111010011010100111001110001
101010001111111001010101101011011100100010110001110101101011101100010110000110001100010101
100011100110100011110111001001111001101110111100100001001110001001110100110110100111000101
111000110100001001000110011100101011101100010110101111011000111011000101110010110101111101
101110000001111101010100110110001000100111000100100011000011100010011101011011110000110001
101011111111101001011101100111011110110001110101111001110110001110110001000010000101100101
101000100010100011000101001100010110110100111101101100010011011100111011011111011101001101
101010001000101111110001100001000010011110100001000110111001110101100001001101010101011001
100010111110101000111111101101111011001110101011011100001011000001111101100100010001001011
110110100011101010001000111000101001100100101001000001111010011111000000110110111101101001
100010001010001011100010001110001100001101101101111111100010110110010111100110000101101101
111111111010111000110111101100100111111001111001000000001110100000110010110010110101001101
100000001010001010110100100101110100110011000011011111111000111111111010011010100101011001
101111100011101110100101110111100101100110010110010100001011110000110011000010101101010011
100011001000101100101100010000110001001100110000110101100010000110010110011111101001011111
101001011110100111101001111110011111011101111111100101111111101111000100110010001011000001
111101110000110100001101000111000001010101000110001101000000001001111110011000111011111011
100001100111110001111101010001111101010000010011100101111110111011101011001101110010010001
110111001101011111000100011011001001011111111001110100000000101010000011100101010111010111
100010011000010000010001111000011011011010101101000111111111101000101000110001000001010001
101010110011010111111111001110110010001000000101101110101000100010111110010111111100011101
111010000110010110011000011000100111101010111101100010000010110110010000110100001111010101
100011010100110011001010110011101101001010010000001011010110010011010111100101100001000101
110111111111111001101010011001001000011011000111111010010011011110010011001100111101111101
110000101000001100100011001100011101111011111110101011011010010000111110011110101001100001
100110001011100110101001101111110101010001000010001010001011000110101000110110100011001101
101111101001110010101111100110110001000111011011011011111001111110101011100100110110011001
101001001011011010111000110010100101101100001010010000011100001000101001001101100000111011
100011011000001000110010011000001100111101111010110101000111101010001101100100101111101001
101001001111101111100111001011111110110001000010110111110011001011100100101110111000001101
111011100010100011001101101110001100000111011110100100011001011001111110101100011110100001
110010111000111010011100100000100111101101010000001101001100001101000000100111000011111101
100110001110011000110001111111110000100001011111011001100110100111011111110011111000000101
101111101011001111100100010000011110111011010001011011110011110010010101011000101111010101
100100000011100000001101000111010010001001000101001011011001100110110000001010000001110101
110110110110111011111111111101000111101011111101101001001101001100011110101110111100110101
100100011100001011000011000001110000101110000001001100011001011101001100100010001110100101
101111001001101000011001111100011101100110111111101111001011111001100101111010100110101101
100001100011001111111100001101110000110010001000000001101001000011110001001010110100101001
111011001111011010000111100101100110111010101101111111101100011111011111100011100110101101
100001011010010000101101110100001100100010100100010000000111110100001000111001110010100101
111100010000111101111000010111111001101111110111010111111110000001011010001101011010110111
110111111110101100000010110010001101001001100100010011010100111011110011101001000010010001
100011001100100001011110111000100111011100001101111000000111100010100110001011110111111101
101010011001111111110000101101110001001001011001011111110011001010001110111010100011000101
101000111011010001100110000111011011101011011011010100011001011010111100011000101110010101
101010001001000100101111101100001001001001010000000001001100010010010001110010001000110001
101111101100011110101000001001100011011111010111111111111111111011011011010111111011111101
100000111111110010101110111011001011000011010100000110001000110001001010000101000010001001
110110100000011000101100101011111001111001011101010000101010000101101011011101011010101011
100110101011010010100101101000010011011101001101111110100011111111001001010001001111101011
101100101011010111110100001111011110000001100001000011111110000011101101011011100001001001
101101101010010001000111100011001000111111110111011000000111011000001001001000111101011101
100101001011111100011100111001100011100001100100001111110100001111111011101110010001000001
111101011001100111110101101100111110111101001101111001100110111000010010000000110101011111
100001001100001110110000000110110000010001111101001100001100100010110111011010010111010101
101111101111011000100111110010000111000100000101011001111110101111100101111111110001000101
100000000001011010001100011111111101111111110001001011100000100000001100001000010101110101
101111111101001011111001000100010000000000011111101010001101101111111110101011010101000001
100010100111100000010011110001011111111110110010101011100101000010100110100010011101101101
111000110010111111000110111011000000100010100110001000110101111000110000111111001100111001
101110111000100001111100001001111010001000001100101110011101001110111011110001100110010011
100010001110001100010101011100001111111101101001100011001001100010100010000101110011011011
101010100011011001000101000111100000100000111011111001101011101000110110111101000110010001
101111111001110011110111011110111110111011100010011100001000101111100110100101011100110111
100101011100111011000011000010000010010011001011010111111010100000110100110100011001110001
110100000110100010011001101011111011011110011001000010101110111110100101110111110011011101
100001010000001010111100001000000001000000111100011000000000100000001100000000000110000000
111111111111111111111111111111111111111111111111111111111111111111111111111111111111111111
