1111111111111111111111111111111111111111111111111111111111111111111111111111111111111111111111111111
0001001000010110000110101000011000010100000000000100010011000000010000000001000010100001000100010001
1011011011000000110000001101001011000111111111010001000110010111000111111111011000001100010001011101
1011000001111111111101100111100011110100000001110101101100110001111100000010011111011111111111000101
1010011100010100001000110011001001010110110100111101000101111100110001111000110101001010000001110101
1011110111000001101010011010011101010100011110011001110101001110100111101111100001100011101100010001
1000010001101011111011110011111001010111001110110011000100011010001110000010001100111000100111111101
1111011100001110001000011000100011010001100100010111101110110011111010111011111101101110110011000001
1001001110111000101101001110001110011101110111000101001010000110010000001010001000101010011000011111
1101100010101101100111100111111011001001000011111101011011110111000111101000100010100011001110110001
1000111010001000110000110001100011100011101010000101010000100100010011001111111110110111100010100101
1010010011101011111110100101001000101110111010110001011110101101111110011000010000010001111011101101
1011000110001000010100111101011110100110000010100101000100101000001100110011011111010100001010001001
1011111110111111010101110001000110110011101110101111110110001011111001100111001101010110101000111011
1000100010110000010000000111101100011000001000101100000100111110000011001101100100010011101111101001
1110101110100101111111111100111001011111111101100001111110000111011011011001110111011000100011001011
1100100000101111000001100110100011001000000101111111000011110011010001001100010010001010111001011011
1001101111100100010100110100001111101011101101000001110110111000010101100110111011101110001100011001
1011001001110001111110110001111001001010100001101101000110101111111101110100001011000111101111001101
1011011100111111100010100101001100011000111111001001010000000000011000110110101001110001100011011001
1001011110000010001010101101100001001110101100011101011111111111110010010010101100010100111010001011
1101001100110110101000100111111011111010101001111001001000000010000111011010100111011110100010101001
1001100111110100111111101110001010110000100011001101011011111000111111110010110010011010110111111101
1011110010000101110000101000101000100111101110011001001001101111100010100110011010110010010011000001
1010111000110101010111100011101110101100000011011011011100001001101010001111011010100111000110010101
1010101111110101000010001110100100101111110111000011000111100011001110111001001010110100011100111101
1000101010100101101010100110110110100011000110011110010100001000011000101101101000110001110001101001
1110100000001101101110111100010011111000010100110000110001111110110011100101001111100111100111001011
1100101111100100100110011001011000001111111101111111100111100011100110110000011010101110101101101001
1001111000110110110011000011001101011000011001010000110010001000001100100111110000001010101100001101
1101100010010100011011111001111101001011001100010110011110111111111110101100100111111000100111100101
1000001111011101110000011100100001101011100111000111010000100000000000100110101100001010110001101101
1111111101011001011101000110101101001000110101111101000111101110111010110010001110101110111100100101
1000100001001011001001111110100111011110010000110001111100001000011111111011011010100110100110101101
1010001101101011100011000100110010000110111011100100010001011011110001010010010000110000101110101001
1011011111001001001010010101111011101100001000001111010111001111000101000111010111111110101000100011
1110010100011101101000110100101001100101111111111001000010011100010100010101010010100000001011111111
1000110001111000111111100110101100101101010000011101111110111001111111111100011010001111111001000001
1011100111000010010000001100100110111001010101001000100010000011001100001001010011101100011100010101
1000001101011111010111100110101100000011010111100010111011111111100101100011110111000111000111110101
1011111001001010010011001100100111111110010010111010110001000001110000111110100101110010010000100101
1001100011101010111001111001110100001000111000110010000101011101010110000100001101011010111110101101
1100111000101010101101100011000001101010101011100111111100010100011111110101111000011010001100101001
1110001110100010001100001111011111101010001001101100000111110111000100000001011011110011011001101011
1011101000110111100101111000010001001011011011000110110001100001110111110101000010000111110011001011
1010001011100000110101100011110101011011001001011100111011001111010000011111110110111100010110011001
1000101000101011100100101110000100001010011011010110001001011100011111000010100010000001000010111101
1101111101101110001110100011010101101110110001010010101100011001010011111010001011111111111010110001
1000110001001000111000101001111111101100100111011000100111110011000110010010111011000010001010010111
1011100100011011101101111100010001000001101101001101110000100111101100110110110001101000100011010011
1001001111110010000100011001000101110101001001100100010101101100100001110100011111001111111111011001
1101011000110111010111001011101101100111011011110111111100000001111011000111000110011100000110011101
1001010010010101010101101111000100110110010000010100001111111101001000011110010100111001110010110101
1011110111000100010001100001110110011100110111010001100000100001101111110100110001110011011010100001
1000010101111110110100111100100011001101100001011111111110101111000000000101110111000110001010110111
1111000100000011110110110110111001101001001101110110110000101100011101110111000110011100101000100101
1011111111011000100100010110101011001011100100110000100111100111010100110001101100111001101111101101
1000101000001110101101000100100010011000110110011101101101110001000110011100111001101011000011001001
1010100011111000001001111101110110111110110011001100101000011101010011001110000011001011111010011011
1010101001100011111101000001000010000000011001100101101110111001111011101011111111011001101010110001
1110001100101111000111011111011111011111001111110000101100001011101001001000001010001011001000100101
1100111110111000010100010001110001110001100000111110100101111010001011011110100000101001011111101101
1001100010011011110101110100010101100100111110001100110100010010101010010000111110101101010000001101
1011001011000000100100000111010100101110000111100101110101000110111010110101100000111001000110101001
1011011011111111101111111101000110001011110100110100010111011100100010100101101111110011011110111111
1010001010000110001000000001111111111010000101100101010110001110101110101100111100000110010000100001
1011111010110010111011101100110000010000111101001101010010100010001000100110000101111111010111101101
1000000010011000100000100111100111000111110100011001111011111011111011110011101100000001110110001001
1111111010111101101110101110001101111100010001111100001001100000000010011001100111111100110010111011
1000110010000111001011100000111000110001110111000110111100111111111111001101001100001110011000010001
1011100111011100011001111111100011100100110101011100110110010001000001011001011101100111011111110101
1011001110011001111100000010101001001110100001011001100011000101110101000011000001110001010100000101
1001011011000011101111111000101100011010001100010011001011111101100100011110011111011011000101111101
1100010001111110101010000010111001001011111001000110011001100101001111111000111000010001010001010001
1101110100011000000000111110001111100000011111101100111100110101100010010010100011000111111111010111
1000111110110011011101101011100010110101010001000101100110010100111010110111111110011101100010000101
1101100000110111001111000000111000011111110101110100110011000110001010010000000011000001001000111101
1000111010100101100001101101101111000010000101010110010111110011101010111111111001110111011111100001
1110011011101100111100111000100101111000111101000011000011010110001000101000011100111100010101111101
1011001011000001101110010010001100011111110101111001011010010011011011100011001110011001110000000001
1011101001011100001011011110100001010000010101101101110010111001001110001111101011010011011011110101
1001101100001110100011000100111111000111000100100100010110001101100000100010101001000110010000110101
1100001001100111111001010101100001101101011110101111000110100101111111111110001100011100110101100101
1001111011110100001111010101111011001001001000100000010100110100010110001100111101110101100111001101
1011100010011101100001110101010010011100011011101011111101110111010100100001100100000100001100011001
1000101110111000111101100100000110110111001001001110001001100010010101111111110111010101111101110011
1110100000110011100100001111011110100001111101011000101011001010110101001100000011110101100001000111
1010110111100110101111111011110000101100110101110011101001011010000101100110101001100111001111101111
1010110011001110100000010000000110100110100101000110101111011111101101110000101111001100011000100011
1010011110011000101111000101111110110110001101010100100001000101101001011111100100011110110010111001
1011000100111011101001111100001010010011011001011110111101010000001011000001110101110000100110011011
1001110101101011001100000111101000111001001011001010100001011111011011101100010100110101101111010001
1100010001001000011111110001101110101011011001101000101111000110001000101111000110010101001001011101
1110111111011011111100011101001100101001001100101010101101111100101010100001111111011100011011010001
1100000000011010001001000101011001101011100110001011101000011001111110101100000001001001010011011011
1001010101001000100011110001011100001000110011111000101011001101100000100111101101101111000110010001
1011111111111111111110011101000110101110111000100010100011100111001111101100100111100001111100111011
1011000100010000000000110101110011111000011011101110111110110100011100000001110010111101100001110001
1000010001000101010110000000011000000011001000000010000000000001010001010100011000000000001101000100
1111111111111111111111111111111111111111111111111111111111111111111111111111111111111111111111111111
