11111111111111111111
00100000000101010101
10111111010000000101
10110001111110110001
10100100100000011101
10001110111011111001
11111010001001010011
10000011101101010111
11110110100001010101
10000100111111000101
10110110001100011101
10100000101001110101
10101110111011100001
10111000010010001101
10011011010111111001
11001111110000100011
11100100011110101011
10110001000010101001
10000101011000001100
11111111111111111111
