1111111111111111111111111111111111111111111111111111111111111111111111111111111111111111111111111111111111111111111111111111111111111111111111111
0010010100000010000000110000100000010000110001100100101100010000001010100001000000000100001011000001010000000100001000000101010000000011010000101
1011000111011010101110100110111101011110100100110001100001000110100010001100011111010001101000010100010111111101100010110100010111101000010110001
1000010100010011111000101100001001000100001110111011001111101111111011100101110000011111101010110111010000011000110110011101010100001101110010101
1111110110111001110010001001100011110001111010001001011100100100010000110111000111111011001111110011011101010011100011010001000101111000110110111
1011000100001100100110111111111110111111000011101101010101110001011010011100011100000010011100011001000111000110001111010111111101100010010010001
1000011101101110001100100011000000001000011110100100010000011111001111001101110111011110111001001101110001111110111010010001100100111111111011011
1101110101100111101101101010011111100011111000110111010111000001100111100001100011010000110011011001000100100010101010111011001110010001000001011
1001000100110000111001001011001100110110000010010010010010010111110010111111001001010111100110001011111110001000101000101010011011010100011101001
1011011110111010001111011001100110010100111111011011011110110011111000100011101101000100001100100010000011111111100011101010110001000111111001101
1010000010101111100001011100110111010001101101001001000110111001101110101001001101011111011001101010101110000000001000001000010101111100001111101
1011010110101000101011010110100001011111001001101101110010011100101000101101111001010110010011111110100011111111011111111101000100011001100010001
1001110110101010111000000100111101000101100011000100011011001111100011100100010011010000111111000000101001000110000110001001111111110011111010111
1100010000001010011010111101101101110001001110010111001001100001101110001111011000011011101000010111111011010010111100100011000011000110110010001
1111011011111011001110011001000101000101011000110001101100111101001000111010010010110001001011111100001010011010001101111110011010010100100111101
1001001111000001100011010011010101101100001101111101101110000001011011100010111110110100011010001101101000110011111001101000111010111101101101001
1101100000011111110110010110010101100111100101000000100011111101000010001110000010100111001011011001001101100110001011001011101010000101101000011
1000111111110101100011010111010000110000111101101010110110001101011110100111111010110011101010010011011001101100101010011001000010110101001010111
1011110100010000111001110001111110111110000100111110010000100111000000110000110010011000101010110110011011001001101011011101011111100100011010001
1000000001011010001100110100000110000100110110000011011111110011101111110111100111001011101010100100110010011011101000010001000001101110110011101
1101111111001111011110010111110011110111100011111001110000011000111000100011001111101110001000101101111110110001001110110111111100001010010111001
1001000101101100000011010000011011000001101000011100100101001110000010101010011110001000111110101100000110010101011000010010000111111011011100011
1011010000101001011110011111001001111100101111001110101101011011111110111010110100111011110000100101110011000111001011111011110000011010000101001
1011011110101011001000110101101100110110100010011010001001010001010010110010100001100000100111110111011010010110011011001000100111001000110001101
1001111000100010011011100000101110010000101011000011111011010111000110100110101111001010001100010001011011011100111001101110110001111011111101001
1101000011101011110010001011101011011110111001111110101010000110010100111110100100011011111110111101000001010001101100100010011011100011000111011
1001011110001110000111111010001001000100011100100010001011111100110101100000110111110001011010100001011101110101100110101111001001001110010001111
1101000010111100111100001010111011110111001101101000111010000001110101101111110000011100010000101111110000000100001110100011101100011000110100001
1101011010110101100001101010001000010100011000101110001000111111010100001100011110110001000111100100011011111110111100101000101111010011111101101
1001001000000101110111000011101011110101110011101011011111100010010111111001000110011111110011001101001000110000010001111110100001010110000111101
1011111111101101000011011001001001100100100110001001001010101000110000001101010011011000011001011101101010011010110111010000101101110011010110001
1010001100000101101001111111011101001110110011011101101000001110010111100111111001000011011101000000101111001110100110000111111100100110010100101
1000100110110100101100110001001101011010111010000000100011100011010000110000101101111111010101101111101101100111101100110110000110001100110101101
1011110011110110100110000101101001010000010000111111101110111001011110011110001000101100010100111100100101110100000001111100110111111101100101111
1010111000011100110011111100001011010111011111100001100010011101110011000010100011100001110110011001110101000101111111101001110001000101001100001
1010001111000001111011000110100001011100000001001100111000110001100111111011111001101111000011010011010100011101000110001011011100010001011101101
1011011001111111000001010100111111000111111100011110011111100100001110101000001111001000011001010110010110110100011100100010001111111111000111001
1011000011100001101111010111100010010110000111110011010000001111101100001111100000011011111100010000110010100111010001101110100000110101110011011
1001111000001011000100010010001011110100110000000111011011111011000001011000111111110010000111110101111010001110010111000111110110000000011000011
1100011011011001111101111011011001000101111110110001011001010001110111110010011001010111010000011101101011111010110011101100011111011111111111001
1111001011011100011001000010001101011101000011111011001101000100010011100110110011000110011011001101001000100010011000111001001000001000101011101
1011101001001111001011101111101101010111011001100001100001101110111001001110000110011100111001100000011110101011001010001011101111011010000001101
1000101111101001101010101101001001010000011100101101111111000010001101011011110011011001101100111111011010001000011111101000100010010011111100101
1110101100001011101010000000011100010101110110111101000011011010101101011000011001001011001110010010001011111111001100101110111011000110000110101
1000100001111010001011111101110111110100110000110001101010011111101001001011110011101001100011011000100000010001100001100010001001101100110010001
1011111111000000101010001111000000010110011101100100111000110001101011101001000110001101101011001101101110110100110111111011101100100110111011111
1001100001011111111000100001101101010011000101001110011010110101001000101100010110111100101001100111111000010110011100010010001110110010001000001
1100001100010000010010111100111001011001010101100011001111100101011110100111111100100110101101110000001101110011010001010110111010111010111110101
1001111111110111011110000110011101111011110101110111100011001100010110110000101001110000100100011111100100011011000111000110000010010010010000101
1011000000000101000111101111010000001010000100110011111001011111110000110110001011010111110101011000110110110001110100010010110111010110110111101
1011111101111101110101000101010110111010111110011001101100010100000111100011011010000010111111000010110110011100111111011010011100010010100100001
1000001100101000000100011100011110100010001011011100101111010101111101001110001011101000100001110110010011010110100001111111001101111011101101111
1110100110100011111110110001110000101111101001001110100110000100010001011011101000111110001100010111011011010010001100001101100100100001001001001
1011110100110110000000010111011011100000101100011000110100111111011100001010101110000111111111000101001001000111111111100000110110110100011011101
1001010110100100111111110100011000111110101110110011110001101001000101100000100111110000110101101101101101110110000000101010110110100111111000001
1100010110101110100010000111010010110010100010000110100111100011110111111111110100111110010001111000000100010010111101111010010010101100001111101
1001010100101100101010111100010110011000111011111100101100110111010000110000000110000011010100110011111111011010110001010011011010111001100010101
1011010001100111101010000101110111010010011001010101101110010001011110100101110111011011010110100110001011010010100101000111111010011011111010101
1001111111110010001011110101100001000111001101000001001011000111000000101111000001110010010011101110100001010110101111011110000011000001010010101
1100010000111000111000110101001011111111101001101101011001101100011111100001111101000110111000101000101101011110100011000100111111111111000110001
1001000110011111101110010101011000000111111011001101011101001001110000101100010000011100100010101011111101000000111001110001100000000110011111011
1111101110110001001011010100011111110011000001100101000000011011011010101111011011010001111010001110000101111111101100011111111111010010110010001
1000101010000101100001010101010000010110011111110111111101110011000011101011001001110111010011111000110000001100000111000001100001011010100110111
1010001011110100110111000101110111011100111001000000000100110110011001001001101111000101010110000011111111100110110011111100110101110010101110101
1011111000110110010001111111000101001101110011011011101110010111011100011100100110011100010111101110101000110010010110000110010100010110100010101
1010101010000111011100000100011101100100010111001001100011010010000111111110110100110001110000101000001010011011010100110011000111010100101010001
1010100011111100001001110110110000110111010101101100111010011011110100001000110101100100111110101010100011001001010101111001110101010101101011101
1010001111000111100011000100011011110100010100000110100010111000110101100011100100110110000010001010101110011101110101001101000100000100101110001
1010111001010000111110011111010001010110110001111100110110101010010000111110001110100011101011111010111000110001100101101101101111111110101100111
1010110011011110000011010001011100010000100111000110010110001111011101100010100010101011001010010010110011100111001101100001001000011000101001101
1010000111000011110110000101001110111111101100010011010011100101010100101000111010111110011000110110011011001101011000111011011011000011100011001
1011110001101111010011111101101000100000101101011011011010001100010110101010100010011000111101110111001110011100011010110000001001111110001111101
1011000111000110011010101100101110001011100111011001001110111001110000101111111011001101110111000001101100110101001110011111101100100010100000101
1001110011110010111010000110100111011001110010001101100010101011100111100000001001101101010100011111100001100001100111000010101110101011111110001
1100011001011010010010110100110100001101011011100111111010001000110110111010101100100101000001110001001111111111110001111010001010101000100010101
1001001100001000110110110101100110111000001000110000010011101110100010001110101110110101011111000101100001100000011100110010111010001110001011101
1011101111101101100111100101110010001111111101100101110110001010111010100110100010100100010001101100111100110111000101100110110011111011111011001
1010101000111101001100001101011011100110000100101101100100111010010010110011111010101101110111001110100110100101010001001110000110000000101001111
1000100010001001011001101101010001110000110110111001001101100011011010011010000011101001000110011000110000001100011011011011110000111010001100001
1010110111011011011101000101010100011101100010011101011001001010010011110010111001001101010010111101111111111111111010010001011101100011011111101
1111100011000011010001110101010101000111111011000101001011011110110111000110011111011001011010101001000000001010001110110100000100111110010000001
1000111001010110010100010101000111110000100001110101101011010000110100010111000011010011010010100011110111101000100000100111111101100010110110101
1010011111011100110111011101011100011010101100100000100001010111100101111101111000010110011110111000000100000011111111110100000000101011110011101
1011000010001001110010011001001101001110101111101111111100010001001101000000001111110111000010001111011111111010001010100001111111101001000111001
1001111011111011011010110011100101100010101000000011000111011101011000011011101100100101010111100001110000001110100010001111010011001101011110011
1011000000110010001010100111110100111000100010111110010001111001001011110010000101101100010001111101100111100010101110111010000110011101010000111
1001011110000111011010101101010110001111111110100100111100101011101010100111110101000110111101000101001101111010100010101000111100110100010111101
1101110111111100000010001100000111100110000110001101110110100010101000101101000101011100100000010100011000001010111010001010010001100001111100001
1000010000100001011111100111010000110010110011111101000110101110101110101001011101000111101111110111111011011010001011101011010101111100110001011
1101010110001111110000110001110111111010011001100001010100101000100011101100010001010000001100110110000010001011111000001011010111000111100101011
1001010010111000000110111100111100001011001100001011010101101010111000101001110100011111101001100011111110101000001111011110010011010011001101001
1111011011110010111110000110011001101001100111111110010100001010000010001011100111110000111011001000001100101111100110000010111010011010011111101
1100010001000111100011110011000011000011110000010100111111111111110111111010001101000110001000011101101001100000110011101000011000110010110100001
1001010101011101001000011001111111111000011111010001100001000000011100001011101101011111101011110111000011111110011000111111001111111000100101101
1011011111010000011111001100100000011111110010011011001100011111000110100011000101000101001011000001111110100011011110010001100100011111110100101
1010001000011111111100011110001111000110000110110010011001110101110010111110010001010001011110011101100000001011010011011011110111010100000110111
1011111011111000011001010011111001110100101100011000110011010000011010000111011011111101001000111001001111111000000110001010000110000111101100001
1000011010000011000011010110110011010101100111010010111010010111000011110001001110000101101101101011111000001111111110101000111100110100001111101
1011001000111111111110010110000110010000110001011011100011010001111110011101111000110101000101001000011011101000100010101110000101100001100110001
1111101111101000110100110000101111011111111101001110001111011101000011000100001011100001110001101111001001000010001011100011110001101100111100101
1000000011000010010001111110100000000001100001100010111000010101010111110111100010111111011111000001101101111111111001001000111111000111100001101
1101111001110111110111000010101101010111001011111010010011110001110000000001111110010101000100011111000100010000101101101110001001110011001111101
1000101100110000110101011011101001011100011110001011011011000111100111101011000011000001010101010001110111010110000101000011101011000110011000101
1110101110011010100100010001101011110001111000101010010000010100110110001001110111011100010001010100010000010111101101111111001000011100110011101
1100101010110010101110111101001000100100110010101011011111110110000010111100010001010111111111010111011011010001111000000000011111001001100110001
1001100010010110100110100101111011101110011011100010000000100011111010010111010111010011000011010001000001111100000011111111110001111011001110111
1011001111010010110100110001000011001011010001111110111110101110001011010000000110011001011110011101111101000110111110000001000100010011101000101
1001100001011010010001110111101001011000010111000110000100100010101110011011111100111100000110110000100111010011110000111101101111000110001011101
1101001011010011011111010000101011011111010010010011110101101000101100110001001001100111110100100110001100011011000111101001001011111100101011001
1001011000010111000001011110101010010001111010111001100101111111100101100101011011110000000101101111111001110000011100001011011000000101111010011
1011001111010001111100000010101110110100100010011100110100110000110100101101011010010110110101100110001100011111110110101001011101101100001000111
1011100001111100001110111110100010110110101111010110011110010101100110111000010011000010011100101100101101001101010000101100010001101001101110101
1001111100100110100010010000110110010100100100010011000011010101001100001111110111111011001110101001101001100100010111100001110111001011000000101
1101010110101111111011000111100011000101110101111001110110010111011111100000010000100001100010001011001011110110110000111111000011111001111111101
1001000010001111000011111101001001111100000101100011100100110011000000111110111110111100111011011001011001010100011011100010011000001011000000101
1101101111100110011110100000011100000111111100101000101101111001111110100000001010000111100001111101001111000110111001101010110011011001010110001
1001000101110100111000101111110111110000110110111010001001101101100000101010100011110011001100101001100110011110000011001011111010011101011111101
1101010100000101100010001000110000111101100100001110111100100000101111101111111000111000011111100011110000110010111010011000110010110001110001001
1001110001111100001111111010010110001001001101100100101110110110101010001000001110001111010010001010011011111000001110111101100110100111000100011
1100111100010111111101000011011111101011011101110101100000011100100011101011100111111001010110111000111110001111100100100100110100101100011111011
1110000111000001000001011010001010001001000000100100111011000110101001100000110001000011000010011101110000100001110101101110011101101001110100001
1100110001111101101101001011100000101101010110101110110011110010001100101010010100011000011011001111000111110101000100000111001100001011010101111
1001100101100000001101111010111111100101111100100010011000011011101110101111110101111111001111100000011100011101101111110011100111100010000100001
1011111100111111111001000010110000110100001001111011001111011000111000111000111111000010011000111110111001001100111000011000110000111111101110111
1001000110100001000011011110000101100111101011001001100001001110110011100010001110011011110010000010001011100110011011011110010110100010000010011
1011010010101101010110010000101101110010101000011101111101100110011010110111100100110000110111111011011010110011000011000110111100101000101011001
1110011010100101110000111111111100100110001101111001000000110011010010000100110101110110010110001001110010111001101001010000100001101011101111101
1000110000110100111011110001000110001100111001000011101111111110010110111110110100011111010010111100100110011100111111111111101011111000111100001
1010011111110110100001010101010011101001110011011110001001100000110010100110000101001101011010000110001111000110010000001100001110001110110001111
1011110000010110111101000101011000111011000110010100111100001011111000101100111101100101001010110000111101110011010111100101111100100100000101101
1000100111010010110001011100001110100011110110110001100111111010001111101001100000110101101010011111100000011001000100110100001001110111101100101
1101101100011010011101000111111000101110100010100111001110001010100011000011111011100100101011010001001011001011111110110101100011100000111110101
1001000110110011000111110100001010101000111110101101100000100010111110011110110011001101101001110101111011100010001010100100111110111110001100001
1011011100011011110001010001101011101010001000100100001101111110011000110010100110011101001011000100100010111011100010101110101010001011101001101
1000001101010010111100011111101000101011101101110101111001000011001011111000001100111001011010011110101110110000001000100100001000100010001011001
1011111001110110010111001011001101101001000101010111000011111001101000001111011101110011011000110010101000000110101111110101101111110110111111111
1110000011000011000001100000011101001101110001010001101110001100101111100001000100010111010010000110101111110111111000110111000110000110000100011
1000111011011111101101111111110100011001011111011100001000100110001000111101110111010000011111011100100000100100001010010001110010110011110001001
1101100001000110101100110100110111111101010110000101111011110100100010010001000010011011110001010001101110111101100011011100111000011000011111101
1001101111110000100110000101100001001101000011101111000010110001111111110111110110110010000101110111101010001001111111001110101101001111110000001
1100111000011110110111110001001101011001011001101010011010000111100000010100011100100110101100010100101011101011000001100010001001111000000111101
1110011011011000000100011101011101010011001100101000111111111100001111010101001001101100100111010101101010101001101100110111101011100011111110101
1111001011000011111101110001010101000111101110001010101100010001111101000001100011101111110101010100000000101101100110010101101110001110100010101
1111100001010110000000000100010000010100000010100010000001000100000001010101001010000000000100000101011010100000001111010000000000101000001000000
1111111111111111111111111111111111111111111111111111111111111111111111111111111111111111111111111111111111111111111111111111111111111111111111111
