111111111111111111111111111111111111111111111111111111111111111111111111111111111111111111111111111111111111111111111111111111111111111111111111111111111111111111111
001010000011110001010000001000100010011000101001100010000100001000001001100011000000000100000000000110100001100001000110100000000100000000100000000110000010100010101
100010101001100100000101101010101000110010000011001000110001101011100011001001011101110101111111010010001100101101110000111111010101110110101110101100101000001000101
111011101100110111111101000010111010000111111001111011111011001001001110011100000111010101000001111010111110000100011010011000010100010100100010111001101101101110101
101000100110000010001101111010011011011110101100110000110001101111011000110111110110010100010100001110011011110111000011000011110110110110111011110011000111001010001
101110111100101000100100011111001110010000001110100111100111000100010011100000110100110101110111101000110001010001111111111111000100100100011000100110010010011011011
100010000101111111111111000101100110111101101000101110001100010001110110001011100101110100111100001011100100011101010100000001101101101111010010001100111010110011001
101011110111000001000001110100110000100000111011100010111111111111100111011010001100100110100001101000101110110001000001011111001000101100010111111001110010011001101
101001000100011101110100000110011111101101100010111010010000111000101100011010111110001100101100111110100011100101111111000100011111100101110100011111000111001100001
101100011110110100100111111100111000000111001110010011000110010010001001001110000100111101100111100000111001001111000001110001110001110100111101000001011101100111111
100111111000100110110001000001101011111100011011010111101111010111111111100111110101100001110001001111100011011000011100100111100100010110001001111101011000110000001
101100000011110010011101010100100001100001010010000000111000010010100000110100110101110101011011011000001110010011110110101100101111000110100011000101001010011111011
100111101010000111001001111110101100101111110110111111100011011010001110000001100100011100001000010011101100110110000100100110100011010011111010010101100011000100001
110000101111011101101011100010100110000001100110110010001001110010100011111011001111001111011111111001000101100000110101101100001001011010001111011100111111011101111
111110100011000100000010001010110011011111001100000110111100100110101010011010011001101011010100101101010101001011111101000110111101111110100100000110110001001100001
110000101001010001010110111010000110010110011001010010000110101111111011000010111100001000000110100001111100011110001001010010000100010100110101101110011011100111101
100111101101111111111100011010111100110000110011111111110100101000001010011110010101111111110100001100000111110000101011011011110111000001110100100011011000110110001
101110111000100011000101110010011001111011100111100010000111101110100010110011000100000110010111011111101101000111100001110010000001111111000111111000010010000100101
100010000011101010010000010110110011000011001101001000110011001000111110011001110111110010110001110001000001010100111111100110101111000011101110001101110110111101101
111011010110001000111111110011100110011000011001011111111010011010101011000011000100011010011100010100011101010110000001001110111000011000101000101001100011101001001
101001010110111111110000100111001110111111111101000110010010110011100001101111101101000011000111000111111001011100111011011000011011111110100011101011001001001011011
101101010100011000000110001110011100000000001001110100110110011000101100001000001101111110010001011100001101000101101010010011010010000110101011001001101100011010001
101101010001001010111111111010111001111110101011000101110111011010100111111011111001000100110101001101100101110100001010111111110110110100101110011101000111110010111
101001011111111011100000001000100011000111101001011100000001001110110011010010100011010110100111101000110101000111111000001000100111100101100110111101110011000110011
100011010000011000101111011011101111010101000011010110101111101000111001010110101110010010111110001011100111011100001111100010001100001100101100011000111110011111001
101111110101001110100011000010000100010001011011010010111000101010001101010110001000111010000010101001001100011001100110111111111001101110100101110010001000110001101
101010000111100100111001111110111101111101011110011000100010001011101100010011011110101011101110111101011110110011110010000000001101000010110100100111101011100100001
101000111110110001101101000100110100011001001100110011101111111001111001111001000110101001100000011001010000010110111011011111100001011010010110101100000011001111111
100010100000011111001101101101100110110011101001110110000110001100001100101101010000101100111111010011011011010010010010001000110111001111010010111001111110011000001
111111110101000011100001000100101100100110001011000100110000100110100110101001111111100110000011010111011001111011010111101010010011101100011010001101000011001101011
100001010111111001101111010110101101101111111001111101111111110011110100001011101010110011111001010101001100100000010100101111011001000101110010100111011001101001001
101100010100001111001100010010001001001000011100011001000001011000010101011010100000011000101101110101101110001111110101101100011101010100110111110001001101111011101
101111010101100010011001111000101011101011000101010011011100011111000101110010001101000010000100110100101011111000110101001001001101110101100001011011100100110011001
101000000100110110110011001111111010101011110111010110010001000001110100110111011001110111111110010110001000000010000100011011100100011100111100001000110110000110011
101111101110110100110111100010010010001001100011010110110111111100011110010001111101100010001111000011011011011011111101111001110111001110101101111110010011111110111
101000111010010001100100001011010111101100111001010010011110000111001000111100010001001110100111111110010010010011000101000011000101100000100001000010110110110100001
100010000011011111101101101011010101001110001100011011001010110101101110000111010101011000110011011010110110111110010100011110011101111111101111011010000000100101101
101111110110010010101001001000010001011011100111010011101000100100100011011100010101111011111001010010100110101100110111110111010000010000100100010010111110001101101
100110010011011000101111011101111101000000110101010110100010101101111011010001111101100010001100000110111100100001110011000010010101000110110101111010000111111001001
101100111001011101100010010001000001101010010100010010111111101100001001110111000001001111100110110010010001111011100110011010111111111110000101010011111100010011101
100001111100010000111011011011011111001111010110111010000001100111101100110001110111011000001100011011000111000010110010110010100010100011011101010110000101000111001
111101010111111110011010010001010011011100010011101010101100110000100110011101100110010011100111001111111101110110011011100110001010001001011001010100110101111101101
100100010110000000110011011011011000011001111001001010100111111010101111001001001100110110001101100000110001000011011010001111111000111101001011000110100100000100001
101111010010110111100110010001001111110011101100011011101100001110100001100011011001100110111000110111100101101110010010111100011111110101101011010010101101010111011
100011011000111100001100110111100001100110000111001011000101101000101111111010000011001100011011100001001100001000110110000001010000000100111001111000100111010001111
101001010010001001111110110110111100110100110001100001010101100011100000001110111111011001001001111100011001111101110111011101110111101110001100001111110011011100111
101101011011100011000000010000101110010001111100110100010100111110001010100100101001011111101100110110111111000100100011000111100110100111011001100100011001010110011
101111010001111111110111011010100011011111000110011111010110001100111111110101100011000011000110000010110001010110001110010000101100110011001111110101111101000011001
100000011011011001100011001110111011001100010111001011110011101001110001000100111000011001110011011010010100010110100011111010100101111001100011000100000101110111101
101111110001001100001001100010001001100111110011101001100110101111100101101110011111011100111001011111010111110011111000100010110101101100111001101110111101010100001
100011011101100001111111101011101100110100011000101100110100100000101100100011000001010110001101000100010100111000011110001010110101000110001100100100011001000101101
111001000001001111000001001010100101100001001101100110000001111011101110101111111101010011101101101101110110011111010011111011100001010110100110110111010011011101001
101101101111100101101101101010110000111111101000110111111100101000000110100100001101011010101001001101000111000110010111000011001100010100110110110001000110011001011
100001000110110101001001001010111101100010001011110100001110101111110100101101100001000000101100011001011101110100110000010110011111111101100100100101110011110011011
110111110010010001011011111010001000001110111011000101101000001100011101100100111111111101100111111011010100010101100110110100111010000101101101101100011011000111001
100100111011000111010010001011011011011100110001011101001111100101000001110110101000000100110110001010010001000100111100111101101010110100101001000111001001011101011
110110010010011100010110100011000001110001100101000101011000111101111111010010001011011101110100100010111011111110011001100000001000100110111011010001101101000100001
100011000111010001110100110110010100100111111101110001001010010001001010000111101011110001000101101110111010001011001111001111101010101100000010011101100101010111101
111011010110010111010110100011111111101100000000111111100011010111100000101100101000000111011101001000010010100011100000011000111011100110111111111000110101110000101
101001110011010001010000101001000000101001010111100000111110010000111111100110001010111100001001011011000110111000111110110010001001110100100010001111100100111010111
101100011001111101011110101111011110001011110100001110001000110110011000110011011110010001011011110001110110101110000100011011100011000101101000100001110110001010001
100111001100001101010100111000010011111010100101111011101011100011000010011000000111110101110010000101100100000111110111010000111110011101001111111100110111101111101
110001101111101001010001100011111010011000101100010001101010001111111011001111010011000100100110111111001101110100010001110110010000110100011001110110000100100001001
100100101011001011010111101110000000110010100111010100101010111000001001100001111010010110101100110001100100011101011100100011010110100111111100100011111110111100011
110101101010011010000100100110111101100111110010010111100010110011101101111100101000110110101001100100110101001001000110001001110011110001010110001001010010100101001
100111001000110011011101110011100001001100010110110000111110100110101000000110100011111100100011101110011111101011110011111100111001100100000111011100011000001101101
110000011011100110010000011000101101011001000110111110000011101110101011111100101110000111111111000011001011001010011000010110001100101111010000010001011111011001101
110111110000001100110111011110101001011011110010001100101000001010001011000001111000110010000000011111100001101011001111000011100110100100011111111111001100011011001
100100011111111001100100000010101111001000011111100101101101101000111010011011000011111000111111110110111100001011100001111000111110110111110001000110011001001110011
101101001010001011001101101110100001011111001000110111000100111011101110111110011110101111100010000100001111111010101100001101100010010000000100010010110011100100111
100111100000100010011000111000101100010001101010110001111110110001100000101100111000000110001010110101100100010010100111100001001011010101111101111010010110110101101
110000101010111011001111100011101111111101001010011100001000100111001101100001100011011100111000111101110101000110101100111111011001011101000111000011000100110101101
111110111111110001100001101110100101000101011011001111101101101100011001001011111111000001110011100001010001111100100110000000011101000100011100011111110101100100101
100010010100010100111101001000110000010001001001100001001101001111111100011000000110011011011001001111011111011001110010111010110101110111110001110000011100001110101
111011010001011110100001011011111111111101101100111100011001011010000111111111110100110010010011011000001101010011111011110010100100010000011011000111001001011110101
100011000111001000110111010000100010101000100110010111110011000000110000101100010110100110110110011111100000010110101001100110101111011111010011011101101011001100101
101001111101101110010010010110001000101011110011010001100111111111111110101001010100101100100100110001111011010000001100111110100000010000011000011000101111111001101
101111100000100011000110111100111110001000011001010111001100000101000110100011010110101001101101110100000011011110100110100010110111111011110011110010100000100011001
100000101110111001111100101001100011101111001100010110011111110001010010110110010011101101001001010111111110001000110010001010010100000010110111000110110111101111101
101010100110001100110001100011101000000001101111110100110000000100011010010100111010001000011011000010000011100011111011111011010101111110100101011110010110001000101
111010110011111110100101001001001011111111100000000101100110111111001111000101100000111101110011010110111000111110001110001001010001001100101100000011110100111010001
110010111010001100001111111101011111000000111111110001111100110001100101111100111110100000100110010000110010010000100000101101011111011001101001011000110001100011011
100110011000100111111011000001011100011101101100011111010001100100110100000110000111101111101111111111100111010111110101101101010110010011101011001010011111001110001
101111001101110000000010011111001001111000001001000010000101001110110111010111110101001000101000110000110001000000011100111001010011000111001111111011000000011011101
100101100101011110101000110011011011001011101111011110101111011010000100010000110001011010001010000110011101111111010001110011011000011110011000010001111101110000001
110100110100010010111111111000001001011001101000010000100110000011111110111110011101110011111011111111000111000001110100100110011101010000110011011101100001000111111
110110010111010110011000110011111101001101000010110111101100111011010000110000110001000110000011000101110001101100010101101111000101110111110111010101001101011100011
100111010001000011000010011001100001011001011010100100100111110000010110100111100111011111101110010000011100101111010111001001110100010001100110010001011111010001001
101100011101101011111111001100101101001101111011101101110100011111000100111100001101010001100000111101000110001000000100011100010111011100101100110111000001110111101
101001000000111001100001101110100111100100001110000100010101010010011111100001111100010100111110000111110110111110111101110001010001000110001001110001010100000001001
101101011110001101001101000011110010110111100100110001010001011000110000110111100101000110000011110011010011100010001101000101011101010011111100100111111111111101011
100111111000101001011101111001011000010001110001111111111111001111100110010100101101111111111000011000011000101011111001011101000001011000000110111100001100001111001
110110001111101111001000001100000011011011011111010000101000011000101111000101100000110001011110111101111101101000110011110001111111110011010100100001100110101010011
100000100011000011101111100111111110001010001100010110001010110010001101111100001010000100010010010001000001101110100110000100110000011001110101110111110100101000111
101111111010011001100000110100000010101000100001010111101011100111111000000111101111111111011011010111011100100100101100101110100101001101000100000100000101100010111
111100001010111100101101110110111011101011111101110100000011001100000011010011000100011000001010010101000111110101100111100010101111101101011111111101111101101010011
100001101011101110100100100010010001101001101000110110111110011101111001111010011101001111100010110001110100000100110001001010100011000111000000001000110000111111001
101011001001101000101110111011011101001100100011100100011000110000001100001110111001100000110110011100010001111110011101101011111001110001101111100010011110001101101
101110011100100011101010011011010101011110101111001111010011100111111110111100001011111101111100110111011111000010110100101000001101011100101001111111000100100100101
100011000110101110101011001000010001011110101000011000010110001100000110011001111010010100110001100110010101011010110110111010111101001110100011000011110110110110001
101001110000101000100011101111110111001100111011111010110011111001110011001101000011000110100111101100110000010010000010011010000101100010111110011000100011100011101
101101011111101101110110100001000011100001110010101011111001000011011001100001011111101110001100001001111011010111010111001010110100110110000110111110111001111000111
111001000000000100000010111101101110111100100110001001101101011110001100110111010100001011111001011011100010011110010001101110100110110011110010000010011100011010001
100011111111110111101000001101000000001111101111011101000100010000100110011100010001011000001011001001001110110000111111100111101100011000011011011111000111001111101
101110000000010000111111111001011111100000100101010100011111110101110111011001110111110010111001101100011000100101100000110010000111001101001011001101110011100100001
100010111111011010010001000011010000111110110100000111001010000101000001001011000000010110001101001111111011101101001011111011010101101001011001100101011000110110101
101010110101001111010100010111110110001010000110110101100010111101111101101001110111010111100101011000000010001001011000101011010000100011001101110001001010100100101
111010010001101100000110110100000011101011111100100100110110100100011001101100010101000100110001011011111110111111011110001001011010111111100100011100011110110001101
100011000100100111111111100101111110001000110001101110110010001111001111001111010001111110011111000010001000110001001011011101010011100000110110110111010110011111001
110111111110110000000000110101010010111101100100100100100111011011100001011000011101101011000011111110100011100101100010010001011111001110110110010001010011011000011
100111100010011111111110011100000110010001101110110001101101001010111100010010110101000001111010000100111111001100110110110111000000011010000011000101011001010011111
110011001011000000001011001111010011010111001010111100100001100010110111111110100001011100010000110101100001011110110100010011111101111011101111111100000011010110101
111000011001111111101001100101011011010100011010000110111101111010000000000100110111000101000110011101101011010010100101111000000100000010111000001001101110010100001
110010111111000001101011110000011110010101110011110010001001001011101111110110100101110101111111001101001010011010001100001111110111111000100011101111000110110111011
100110000100011011001000011111110000110100110110011011111011101001100000100000101100000111010000011001011000110011111111100000100100001010101111000011110010010000001
101110110101110011011010111000100111100110010100111000001010001100110110111111100101101110010111110011011111100110110001111101101110101011101001111000011011011111111
101100011101000110011110001010001100110011000101101111100011011110011100100001110111001000110100100110010010101100000100000100101000101111001100001110110010010000001
111001111001011100110000101011111110111000010100000000111110001011011001101011010001011011100001101100111000001001111111101110001101100100011001011010011110110101101
100011100011010001111101101001100000000011110101101111110000100001010011001000011100010010001101001001101101111011010110001011111001110101010011000011000100000111001
101001001111000101101001001100111110101001100100100000011111101101010110011110110111110110111101011011000001100010000100111000110011000101111111101001110111110100011
101111011101111100100011011110000011111111001111101101001000100101000100110010110101010100110111001001111011001110110101110010000110011101100001001100010000010101111
101000010001000110001110011011011011000001100001111001100010110111111101100110010001000001100100011100011001011000011101100111101100111000110100011111111111010100001
101011111011010011011010110001110000011100111101010011001110010001011000110011000101011111001101000111010011011011001100001100101110010010010111010001100001011111101
100010101001011001110000110100111111000110001001000111111011010100010011111001101101010011100101110101010111001001100111111001100011011011010001110100001101000001101
101110000011001100011110010110010001111111101011011100010011010101110110111101100111011010001100110101010101101111110011000011111001001110011011000111111001111100001
101100110111100101000011010111000100001000001000001001010110011101000100010100110011010000100110100001010000100001111000011000011101100111001011011110001011010111101
100110010010110111111011110101111111101110111111011011010100110001011111000110011000010101101100101111010101111100100011111101010100110001101000011000100000010000001
110011111000010110001010000100000000100110010000010010010001110101000110010111001111111111001001100110010100000110101111000111000110011100001111110011111101110111111
111000000011110100101010111111010111110011011111110110110111010101101100110011100000000001011011101100111111110110101100010011101111001111111000000110000100100100101
111101111110000101100010100001110000011001000000010100100100000100100001111000001111111101010010001001100000000100101001111010001111100010001011111110110101101110001
111000100000111100111010001100010101001101011110110101101111101110111111111111111100000000010111011011001011110101111011001000100110111010100001100010011100101000101
110010101111100110101111111101011101100101110000010101100001001010101000110010101001110110110101011011111010010100110011101111110010011011111100001011000001101101101
100111100000110000100110000111001111001100100111110100110100011000000010011000100011011111100100001001000011000110000110100000011011001000000111011001111111001000101
110101111101100111110100110001100011011110110110000110011111011111011111011101101110010000001110101101011111110011111110001101110011101111110001111101000100011011101
100100000100110000000001111100101001011010010010111111010001010001110000010001000111010111111000111001001000100110000000100100011000100001011100100000010001110010001
101101110110011101111111001110111101000011011010110001000101110100011101110101011101010110000011110011011010111100111111111111001110111100000110111111110100100110101
100100010011011000110001100000010101101110000010010101111101100111011000000101010000010011011110100110010010001101100001000001100000000110110010100000011110101100101
110110110111010011100100110111010001001000101111010100000101001101001111111111000111011001011000101111000111100001110111011100111111110011100110001111001010100101101
110100100110010110001110011110000111011011111000010111111100011101100100010001101100001101001110100101011110111111000010010110110001011000101111111001100010111101101
100111101100110010111011000011111100010010011011110110001111110000110101000101111001100101101100110001011000101011101110110010000101001110100000100011111010000100111
101100001101111010010001111000101001010111010010010000100100111010010001111100110011110100100001111101010010001000000010100111111101100000101110110110100011110110001
101001111001010011010111011110101011000000010111000111110001100011011011000110000111100110101111010001010111101111010110110011000101110111100010000000101110010111011
100011000011010110010001010100100001011111110011010011000111001010001110010011111111001100100110000111010001000001110010010110010100100001111011010111101011010010001
111010011111000011010100000101111111000100011001111001010010011010100100111001000110011001110010111110010101111101000111010000110110101100110010011100001000011000101
101010110101101001011110101101000010011101001100101101011011110011110111111011010011111100111010110100111101000101010101011011110010111110010110111001111101011111101
100010110000001101000010100100011011010001011110101111010001100111010000010010011000111110100010000110000101011100010001001110000110011011000110110011101001110001101
101110010101011001111010110111110010010111001000101000010100001110011111000110111110011100101111110011110001000111111101100111010111001001110100010110000011000100001
100111010111110011001011100001010111010011100011100010110111111010111001011110100011001001100011011000011111101101000100110100010001101100000111110100101110011111111
110100011100011110011010001100010001011000111110001110010100011000110011001100101111100011101001001111001101101100011110100101111100100111011110000101101000110000011
110101011001000011000011011111010101001110010010111011010101001110000111101001100000111110111101101101100100100001000000101101010110110001110000111101001011111011001
100101110011011010011110001010011101111011011000000001011101100111101100001011111110001000010001000000110110101111111111101001000100011100011011100101011010110001101
110101000111110010110100100010110001000010010011111111001000110001101001111000000100111011000111011010100100101100001000001011010001010111011000110001110010010100111
100101011101000110110001111011100111010110110110000001100010011100101011101111110110100001111101111010101101100001011011111011111111110001001010010100010111000110011
101101001001011110011101010001001110010010100100110100110111001110100010100000010010001111000001000010100101110101110010100010000010000101101111011110110010010011001
100101100011000011000100010111011010111010101101110110011111011000101110001111111011011100011100011011110100000111100110001010101000101100100111010000011010111111101
101101111011110111110111010011000000101000100100011111000010010011101000101000110001011001000101110011010111011100001111011010111111111001110010011011011011110001101
100100101010100000010010011001111111101111101111000011111010110110101011100010011101001111111100011110010001111001111101001110011100010011011000110010001000000100101
110110000010101111111011111100000011000001000011011000101010010100101000101011000101100000000111010000111100010011000001100011001001000110001111100111111111111110101
100111111110100100011000000101011001111100010110001110100011010110001111111011110100111111110001010101100111000111101100111011101011111100101010110110000001000010001
101100010000110101001111110111011100000111111100100010101110010100111100010000110110011000011101010101001101111110001110011010001001000001101000100011011100011011011
101001011010010001100011010001010111010000001001111110100100110101110001011111100011010011010000010100011000001100100111010010111100011011111010001010010001011110001
100011001110111111111001011100010001111111101111000110110111100101000111001100001001000111011010110110110010111001110010000110100111110000110010111010110111010000111
111111101000100001101100010111110100100000101000010000100011001101101101101001111011111101001111100010010110110011011011111110110100011110100110101010110001110111101
100000000010001100000101000000000110001010000011011010101000011000001000000011000000000001100000001011000010000110000000000000000001000010001100001000010100000000000
111111111111111111111111111111111111111111111111111111111111111111111111111111111111111111111111111111111111111111111111111111111111111111111111111111111111111111111
