1111111111111111111111111111111111111111111111111111111111111111111111
0000100010001010000000011000100001010001100000110010000010100001100001
1010111000101000110111001010101100000100110110011000101010001101001101
1110001101111011110011101010100111101110010011001110101110111000011001
1011011000000010011001001010110110100011011011101100100000001011111011
1001001101011110111101011110000000111010001010100110101111111010110001
1011100111000110011001000111111111100011101010110011111000010010100111
1000110011110011010011010100010001101111000010011010000011000110101101
1101111000011000010111110001000100001001111111001011011111111100100101
1000011111001111010100011111011111101101010001100010010000101001110001
1101000101101010010101010001110001111100010100101111010110100011011101
1001101100001000110001000100100100000101000101101000010110111010011001
1100111001011011111111110110101111110101110111001110110010011000110011
1110110011111010101000010100100011000100111110011000111011001011110111
1000010110110000001011010101111001011110001010110010001011101000000101
1011010100011111011011011100001101000110101000100111011010101111101101
1001000101001000001001000111011101110011100010110001110000100001000001
1011111101100011111101010011001000111001001111100101000110101101111101
1000011000111110011001011001100010011101011001001100011111111001000101
1111010010000000110011111100110111010001011100011001110000011011010101
1000011111111101110110111110010101110111001111001111000111001000010111
1011111000000111000100011011010100000101100001111000011101101110110001
1010000011110000011111010001011101110100111101000011111000100100011011
1011101110111111110000000101000100110110000101101110001101110111001011
1000100100010101010111111101110110011100110001000100100101100001101001
1110110111000001000000011000010011000101110111110101110000111100111101
1100100011011101011111001111011001110111000100000101011110000110000001
1001101010000100000001100100011100010011011111011101001011010111111101
1011111011110111111111110110110111011010011010010001100011010000001001
1001010010000011000100000100000011000010110000110111111010011101101011
1101000110111110010001111111111001111110100111100100001010110000111011
1101011100100100111101000000001100000010110011001110100010011010100001
1000011001110101100001111111011111110110111010011000111011001011101111
1111110011000100111011100010000101010100011010111101100011101001001001
1001100111010110001001001011110000010101110010000001111110001111011101
1100110101010011101011011000011011000100010111111111000010101000010001
1110100101011001101110011101001011111111000101000010011000111011110101
1000101100001100100000110111101001100001111100011000111011110010000101
1110001101101110111111100010001101001011000001111111101001100110111101
1100111000111000001000111010111000011001011111001000001011001111110001
1001100011100011101010000010011111111111000001100011111001011010000101
1011001110001111001111010111010000100100011100110110001101011000111101
1010011011011001100010010001000110001101110101100100100101001101110101
1010110010011100111010110111111111100101000100101101110101100001010001
1010100110110110010010010000000001110101110110101001010100111111000111
1010001100010011000111111101111100110101100110101011010110100001101101
1011111001011011011100001001000110010001001100101010010000111011001001
1000011111010000000001101100010010111111011001101010111111100010011101
1111000010010111111101001001111010101010010011001010101000110110110001
1011111010110011000111011111000010100000110110011000100010100100100111
1010001010111110010001000100010110110111110111011110110110101101110001
1000100010000100110101110001111100000110000100000010010100000100010101
1011111111110001111101100111000111110010111101101011000111111111010101
1010100000011011000001001100010000011010001101001001010100011000010101
1010001101001111011011011001111110111011100101011111011101010011111101
1010111001101100011001110011000110010000110111001100011001000110000001
1011100011101001110011000111010011011110010011100001110011111111010101
1000110111001011000110011101011011001010111000111111000110000011011101
1110000101011001111100110101011001101010101110000010011111011001011001
1011111101011100100001100001001100001010000111111000111000011101010011
1000101000010001101111111101101111111011101100101111110011000100010111
1010001011110100101100010001100110001000100110000011010111110111110001
1011011001000110000101000100110000101101110011101001000011010110111011
1001001101111100110001111110011101100100011001001101011000010010101001
1101100100001001111111000011111000110101001101101001001101011010001101
1000101111101111101000010110001111110101101001001011111101111010111101
1110100100001000100011110000101000000100100011101010000111100010011001
1000110101111010110110111111101101111110111111001000110110001011001011
1010010000000010000100000000000001000000000000011010100000101001100000
1111111111111111111111111111111111111111111111111111111111111111111111
