1111111111111111111111111111111111111111111111111111111111111111111111111111111111111111111111111111111111111111111111111111111111111111111111111111111111111111
0000011000001101000001000110101000000000111001100011000100001100001000110001000100000010001000010100100010000011010000110101010001111000001100000101001010001011
1001110010100101011100010000001011110110010011001000010001101001011010011100011101011110100011000001101000101000010101100100000100110011101001111100011000100001
1100100110110100000111111101101001000111000110011101111111000011010011000001110001000100101001110101101111101111000100001101111110100110101011000001010011111101
1110101111110001110000010100101101011101110011010001001011011111110111101011000111101101111100011100100000100001111110111000001000101100101010011111000110011001
1100111000100100111111000110111101001100111001010111101000001000100001001110011110101100110111000111111110111101000011100011111010101001100010110011111100110011
1001110010111110100011110110001001100110001101010100001010101010001101011000110000100110010001110010000000011001011000001010001010001100001010000110010110010111
1011000110000111101010000011100011110011100101110111101011111011111111001101100110110011010111011000101111110011001111111010101011111001111111110011000111010011
1010011111110011001011011000111010111001110000010001000001100010000110011000110100010110010010001111111000010111100100001110101000100011100000111001110101011001
1000110110011000011001001111110000101100011111011101010100101111101100111011100101010100111000100000110011010100001101100000101110111010001010011101000000001101
1111110000111111111101111000011110101111001101000001111111100001000101110010001101110001100011111011100110010101111001111111100000110010111111000100011101111101
1000011101110000010100000011010100100011100100010100100001111101011100000111011000111111110110001001101100110001100011000001111011100110000101110111110000110001
1011000001011011000111111111010101111001110111011111101100000001000111111100011011100000000011011100100110110111001001101111000001111111010001000110100110100101
1001111011000001110000001100010100001100010001111000101111111111010000000001110000111111111001011001110100100001011101100001011111000001110111010010001111101101
1100001110011111011010111001110111101001011100110010001001100000011111110111100110000100011101001100110101111111000111001100000011010100100011011010111000001001
1001100010110000001011100011000000101101000110010111111011001011110000010100101111010001000101100101100101110001110001111111101001010110101110010010010011111011
1101111010011101101000001111011010100111010111000101100010011010011011000101100011111101010001110000101100100100011100010000111111010011101000110111010110000001
1000010011010001001111111100011011110001010101111101001010110000110001111101111001000101110111000111100110001111000111000110100011011010001011111100010110111111
1011010111010111111000000111001000011100010100001001011010011111110111010101000011010101100011111110001111111001110001111100101000001000111001001001010100011001
1111110001010001100011010001101011001111110101101011001011001000000100000100011110010111001001100010100010001100011100100001101111111111101100011011010111001011
1000011011011100001111011101111110011000000101001011101011101011111101111101110000110001111111001000111010100111010110101100100100000110001111011001110001100001
1011000011000101011000010000110000111011111101011010001010001011001101000000100110011101100001011010100010110100000010001001110111011100100001001100111100111101
1011111001110111001101010111100110100010000101011000111010111001100100011111101111110000101100001111111110110101111110111011000110011001111101100110001110001101
1000001111010001111001110110001100101110110001001111100010011100110101110010001000011110001111111100011000100100000110011110011100110011000101101111101011100111
1011100000011100010011100011011001100111111011101000101011000110110100111010101011000100111000000101001011101101110011001100110001100111110100100001101000110001
1001111101010111000110111001001111110000110011001010001011110010100110010010111011110110100011110001100010001000011000011001111011101110100110111100101110011011
1101011001010101111100001101100100011110010110011011101110100110101111000110001010010011101110010111111110111111001111010011000000100010001110001110100000110001
1000010011010000110101101001110001000011000100111000111100101100100000010011101010111000101100110110100000100001100001110110011011111011011011100100111110110101
1011110111000110010100100011011111010111111101101010000001100101111111111110100010101110100001111100101111101100110100110011010010001001000000110101100010011101
1010100101111111000110110111000011010110000101001011110100110100001100000000111110000110111100011001100000100110010110010110011110101100011111100100001110110001
1000101100000011010010011100011001010010110101100010010101110111101001111011100000110100000110110011111110110011010011010011000010100110110000101111011000010111
1101101111011110011011001001111101111000100100111010110111000100100011001010001011111101011100000111010000110110011111111001101000110110100110000100010011110001
1000100011000100111111101011000100001101101110010000010010011101111110011000101000001001001111110010000101100011010000101100101111110000101111011101110110011011
1110111001101101101000001011101111101101111011010111111000110001100111001111111110101011100100011010101111001110010110000110100100011011101000010001100100111001
1010101100100101101011111001101010100100010001010001101111100100110101100000110000101000111101000010111000011000110011011110110101001110001011110101001110100011
1000101110110000001000101100100000110101000111011100100010001110010000101111100111111010010001010110100011110011111011010000100101100111011010000101011000101111
1011100010011011111110001110101101100111110100010110001011011111011010001000101100010010110111110110101110111000101001000111111101110001011110111111011010100001
1001110111010010110011100100100100001110000101110011111001000110011010111010100001010110100100111100101100011110001101111100001000011101000010000001000010101011
1101000010010110100110110001110111111010110100111000001101110010110011100010101111010111101110100001100111010000111000011001101110110001111011111100011111111001
1000010110110110001100011111010101011000011110100010100100111010000110001110111100010001100010101100110001010110011111001011000010011011000000100111110000010011
1111010010010010111001000000010001000010111000101110111110010011110111011100000001011100111010100110111101010011001011100010011011010011101110001110110111000111
1100011011011010010011110101111101011110100011101010000011000110000100010001011111000110001000110010010000011001111000111111110010010110001100100010100101110011
1001001111010011000111100111000001011000101110100010101001111100111101110111110001110011101110111010110111111100010010000001100111010111100111111010101100011001
1011111100010111010011001100011111110010101010001111111100001001100100011100000100011110000110101010010011000101010111010100101100010000110011001010101110111101
1010100001010100011001011001010010110110100010101000010001101011001111001101111111000111010010101010111010010111010110010111101001011110011010011000101000000101
1010101111110101001101001011111010000100111010111011011111100011100001100100110001010000010110101010100010110001000100111100001101011011000010110011101101011101
1010100101100101101101011001101000101101100010100010000000110110001100110110000101111111111100101011101110011101101101101001111001010011111110100110001101010001
1010110100110100111001001100001110101100110111101111111110010011111110010111111100001100000001101000101011010100100100001011000011010110001010001100111001110111
1000010110100111100011111111100011100111100100001000000111011000000000110000000111101001111111101110101001010110110101011001101110010010100010111001110011000101
1101110100001100001110100000111001110010001111011101111100011111101111111011110100100011000000100100101101010000111101110011000110111000110110110011000110011101
1111000101111001011000101101101101011000111010010001000001110000000110001000110101111110011110001101100101010111100001000110010010011010110000100110010100110001
1000010100110011110010000100001001000011100000110101011111011111110100101110100100000111000011100100110101010001101101011110111111001110011111101110111101110101
1010111101100110000111111101101011101110001110100111010000000000010101100000101101110001011010110101110101011100001001001100001101100111000100100010010001000101
1010000100001100111101010100111000100110101000110000010110111111011101111111100101011101001010000100000101001111101101100111100100110101110001101010110111011101
1110110111111101110001000110001110110010101111100111010011100001000101001010110101001101101011111111111101101010000111110100110110010100011101111010010000010001
1100110100011000000100010011100010011011100000101101111001001101110001100000010001101001001000100000110001101000110010100110000011010111000100110010111111111011
1001100101000011111111110111001011001000111110100100110011011100011111001101011111100011011101101010000100101111111010001111111010010010011110010110000000001001
1011001101111110100000100100011111101110000100110110000110000111000110011111011010001110010100101111101111100000111110111000001010111011000011010011111011011101
1001011100000010101110101101110000100011110001100010101111110001110011001010001000111000110110000101001000101010011000100011101000001011111011010110001110000101
1011000111111010100110111101100101111001011111111011100010011100111001100011111011110011100111111100011010101111000011110110101111111000001000010100100110111101
1010010100000010110010011001001100011101001010110010001011000110011100101000110001100110001100000101110010100101101000110010000100001101101111110001110010100001
1010110101111110011011000011011111010001100000100110111000011111010110111010010100110000101001110100100110110000111110011011110110100111001000111111111010101111
1110100101000110111011110110010101000111110111101100001101001000010010001111000110011110111011000101101110111011100011000011010100110010011010000000101010001001
1000101101011100001010000100110001111110100000101001011001111011110111100101111111000011100010011101101100010010001011111110010110011000110011111010100010111011
1101100101000001101010111101111100000010101110001011010011100010000000110001100001110110001110111000100111011110101010000100110011001110110111001110101110010001
1000111101011011001010001001000001011110001011111001010110001111011111111100001011000011011010001110110001000000111011010001111001100110010100011000100011011101
1010000001010010011011111011101011110000111000001101010010111100000001000111111001111001010011100110010101111111110010011101101100110011110101111011111001010001
1011111111010110110000011010111011000111101101100111011010100101111011010000011101101100010110110011011101001100010111001100100110011000010100001001011101000101
1001101100010011111111000010000010011110000001110000010010110000011010011111010001001111110100011011010001100001110011100110001111011010110111101100001001101101
1100001001011000110011111111011110110000101101000111110110010111010010110001000111011000000001001010010111110100111010110011111001001010000000000101101011111001
1111101111001010011010100000010000100111111001010100011111011110010110011011111110001011110101101010110010110110101000110110000011101010111111110111001001110011
1010100010011111001000110111010111110000011011111101001001001100110011011000010000100010010100111010011000010100001110010100101110001111110001000011101100100111
1000111010110001100010110001110100011101001001100001100011100101111001001101011111101110110101100011011111010111111011010101101100111000010101101001100110110111
1101110010110101110110011100100001001111111100101111101000110100110011101101010000100000010100110111000100010010000010010001100001100011000100111011001100100011
1000010110100100000111001110001101100000010110101000101110010110100110001001000110111110110111100001101101111010111000111111001111001001111110001001011110101001
1011010110101111111101100011111111111111010000001010111100110010101110111011111100000010010000001101000101000010011111110001100000011111100011101101000110101101
1011010010100011000000110111000001100011011111111010000001111011101000100011100111111011011111111001101101111011010101100100101111110000001001100111011100111001
1001111010111001101010010010010100110110000000000010101111101000100011101001001101000010000100001100100100011001000100001110111000110111111100110001010001110011
1100010010001100111011111010111110100110101111111011111000001010101111001101011001011111111101100110001111010011010111011000100010100100101110111101010111000111
1111010111100110001000001000101000110100111000011001000011101110101001111101010011000001000001110111101010010111110110011011101110001110000010001000010011010011
1000010000110111101011011111100011100101110011001111011110100010101100000101000111111101101111010101001000110001100100110001001011111011111011101111011001111001
1010111101100101101110010000001110101101010111100010011000111010101111010001010010001100101001010100011011100100001101111101011000000000000000100001001100101101
1010000100110001001000110111111000000000010011001000110010001000101000011111011000100110001011000110111001111111011101011000011010111111111110111101101110000111
1011110110010111011011110100011111111011011001111111100110101111100011110000001111110011111010010100001101000110000101001111110010000100001010100100101011110001
1000010111011100011000100001001100010001111100110001101100101000111110100111111011011000100010111111111000010011110101100110010111110001101000001110100010011011
1101110101000101110010001101100101011011000110100101000110101010001010001100001000001110111010001000011011111001000001110011000101011111001111111000111010111001
1001000001110100011011111111110101001110010010101101110100101011100000111001101010111010110010101101001110001101111111011001011100000001011000011101110000100011
1011011011000101001010000001010001100000111010001001010101111001111110011100111010000010000111101001100000100001000100011100010001010101001011001001011110101111
1010011110011101101110111101011111111111100010111011010100001101010111001110000011101111110001001011110110111111010111000001110111111111100011100011000010100011
1110110000110100100000110001000000011010101110010011010111100100010011100010111110001000111101011010000011100010010001101101010001000000111110111111010110111001
1000110111100001111111100111110101000000100011110110010101101111011000111010011011011010000001010010110110001010111100111000010100010110001010100001110100011101
1010010000101111000000101100100101111111111001100100110100100001001010101011000010010011111111010111100010111010000110001011011111110011100000101100100101110001
1011011110101011011111101110101100011000001101001101100110110101101110001001111010110110100010010000110110101011010011101111010000111000101110001110110001000101
1010000010101001000000100010001111000011100001011101001100100101101100101100110010110100001110110110011100101001111000100101011010011111101011111010100111011101
1010111110101100011110111010111001111110111111000100011110101100100111100110011010000001101100100011001001101100101110110101001011000000001000000000111100010001
1011100000100101111000100010101100000100000001110101110000100110110001110111001111111100111001101110011011001110000100110101101011111111111011111111110001110111
1000001111110100110010101110100001010111111100100101011010110011111100000101100110000110010011101010111001101011110001100100001000110001000010000000000111010101
1101111000100111100110101100101011110100001110001101000010011000001111110001110011010011110111001010101100100000111111001101111110011011011111101101111101010101
1001001010101100001100100101101001100101100100111001111011001110111000111011011000011000110101011010000110110111100010011000000111010001001000101001010100010101
1011100010001110111111110100111101001100110001101011000011100010000010001001001111111110000100000011010100110000101000111111110001011011100010111011010001110101
1000101110111000100000110110010001011110011111101011101110110111111111101100011100000011111111011110010101100101101111111100011101011010111110001010010100000101
1110111100011110101110000111000111011011010000001000101100000100001100000111010111111010100001110000111101101100100000011001000000010010000011100010110111111101
1010011001000010100111111101111101000010010111111110001001111101100001010101010000001000110101000110011001001110111101110011111111110110111000111110000100001001
1011001011011000110000100000001101111011010000110011111011000101101111111100010101100010000101101111001011101010010100011110001000100000001010000011011101101101
1011101110001111111110111111100001011010010110000111000011110100101000111001110100101111111100100011101011000011000111001100101010001111111111011110010000100101
1000100011011000101000110000110100010010111100101100011110000110111010010011100110111000001110001110001010011011101101100101101010111000010001000100111110110001
1110111001110010001011100110100101110110011001100001111010110010000011000110001110000010101011111100101010110000100001110100101111100011000101110001101000011101
1000001100100111101011001100110100110111001111101111000000111011111111111111101011111111101011000001101011111110111011010110100011001111101100111100001011110001
1011111110001100101000011101100101100101100010101001011111101010110000010011001000000110001000011111001000110000101000010000111001011000111110000110101000011101
1010001011111001101010110100101111001100111010101011000110000000100101011001011110110010111111110001111110011011101110111111101100010010011011110011101011001001
1000100010000011101110100110100010011110110010001011010011011111101101001100001100111010110001100100100011001000000010110001000111110111001000111011001001101111
1011101110110110100010001110101000111000100110111010011001000110000101100110111001101010000100101101101001101011111110000101010100000011101010101001011111100001
1000100000010110111010101100101111110010001110100000111101111100111101110010000011001011111110100101001100101110000100101101010001111110000010001101000000111101
1111101111110010110011111001101100000111011010110111100101000001110001011011111111011010000010001100011110100000110111101100010100100011111111011001101110001101
1000111000011000011000100011000111010101001000100000001100011111000111001000001001010010110111111001011000111111100001100111111110101011000001110011000110100001
1010011011010011001110110111110001110001101011110111111111110001101100011111101100000110011100001111110010000010111100110110001011101010011011000110010011111101
1011001011011011100010010101011100111111101010011100000110000100100101000000101101011110110001100000010111111110000110010100100001101010111001011100110110000111
1001101010001001110111000100000110101000001011001101110100111110110101111110100111010000011011111111010100000100110011010101111100101000001101001101110100110011
1100101011101100110001111110110010001011111001100001010101100010000101010010110010010110110000100001000101010101110110010100000110101111111101100111100101111001
1110101000101110010100000000111011101010011100110111010101001011111100011010011010110100010110101101010101110001010100110111101110101001000001110010001101101101
1100101110100100111110111111100001100011000110100100010101101001010111010011001010000101010011101001111100111111010101100001001000101011010101011011111100100001
1001100010110101100000110001111100111111010010110101000100101100000001000111011011110111111010001011000110000101010001001100011011101001011101001001000001101101
1011111010110101001101100100010110110000011010110111110110100111110100011100011011000100011010111010010111110100011111111111110000101101001001011101011111001101
1010001000100101011001001111010000011101111010010000010000110000011111110001001001110101000010001000110010010111010100011000011101100101101011000100000110011001
1010101111101101010011011001011111011001100011010111011111111011001000000101101100011101111111101101111000110011000001001101000100110100101001010111111100110011
1010100000100111011111001101000010001011001110010101001000110001111010111111000111000100000100000111111110111001110111101001110110000001101100010000001101110111
1011111110110010000001100101111010101110011000110101101110100100100011100001010011110110110001110011110010001101100100101100100110111011101111111111100100100001
1001110000111011111011110100001011101000110011110000100100001111101011001101011001010011111111011001100111100000001110101110101100011110001010101000001110111111
1100100110101000000011010101101011000010110110100101110101111000001110011001111100011001010001001100001100101011011010100110100101010000111010000011111010000001
1110101100001111111010010100101001111010010000110111000100001011111000111100110110111100010101100111100001111111110000001100110111010110100010111110001011111101
1000100101100001011010110110111100100011011110100100011111011010000010001110010100010111000100110000111100011000011111100101110001010011101010101000101011000101
1011110100111111000010010010000110111110000010110101110001001000111111100011000111010001111110010110000110110011001000110001011101011000101000000010100010011101
1001010110010000011110111011110010000011111010010101000101011111100010111001110100010100110011011100101100100111100010011111001101001110101111111111111000111001
1101000011110111110000101000010111111000100011010100011101010000001010010011000101110110000111011001111001101100111111000101101001100100100110001101011010100011
1001101111000100011010001111010101001110101110010111111001110111111011010110010100100011010110010011100011001110100001110100100011110101101100100100010011101001
1100101000011101010011011001000100011100100010110011001011000011001001010110111110111011010010110111001110011000101100010110001001000100101001110110110111001101
1110101011111001010111010011110110111001110110111001011000011000011101000010011000010001011010010110011000110010100111010011011101110110101011010100100100011001
1010100010000011000100000110100010110011000100011101011111111101110101011111001111010101001111010100110011100110110100011001110100011100101010010101101101110011
1000101110101001110101111100101000100110011101110100010100001111000101011011100011011111100011010101110111001110011101011100100001000001111010110100001001000111
1011100000101100111111000001101101101110110001010111000101100000010001001010111010000001110110010000010010011011010001110110111111110111000010010111111011101101
1000111011111001100011010111001111001000010111000011110101110111111111100010001011111011000110111011111010110000000100100100100000100011011011000000110010000101
1101100010001101001010010000011010011011110101111000110100011101010000111011101000110001010010100000110010011111110110101101101110111001001001111110000111110101
1000111110100111011010111111110010110010010000010010100110111001000110101001001110011100010110101110100111000100011110000100001010001111101111000111111101010101
1010000100110001011000100100000110100111011111010110001100110011010110001101100011001101010010100111101101110101000011111111111011100010101100010011000100000001
1011110001111101001111110001101100101110000001010111011001100110010011101001101001100111111110110010001000000101011001000000000010111000101001111001010111111111
1011011111101001100011011011111001100000111111010001111011001110111001101011001101110011000010111110111111101101110011011011111010101110100011001100010011000001
1001000000100011111001000010010011111010010001010111000011100100101100111010011101011010010110010000110001100000110110001000100000101000110111011111111000011101
1101011011101110101100011011010110010011110100011100011110110001100110000011110001001010110011011011100100101111100100111110111110101011100100001110001010110001
1101010001100110000111110010010010110111000111111001110100100101101111111111000100011000010111001000001110100100101101101010100010001001101110100100101110110101
1000010100110010110011010110111010110101011100000011000001101111000101000000011111001111110001101111011010110101100000000010101011101101001100110101100110010101
1011111111111010011001000100001010100100001110111110011101100110010100011101111001101010010100100001110000100101111110111110101001111101011001111100110011110101
1010110001111011001101011101111010001101111010100000110000101100110111001001000011101000111110111100100111110001000011100010101100000101000011010001111000100111
1000100100110001100100001100001011011101000010101111111110100101100001101011101010100010001010000110001101011100011110001010101111011101110110000111011110110001
1110101110000101110111111001011001110100011000101000001000110101101100111010001000111111101010110111111100000111001100111000100101001100110100111110000110110101
1000100011111100110110001011011100000101111111101011101011110100111001100010111111101000101010100100010110101101101001101101110101100110010101110000110100100101
1011110110001101100100101110000111101111001000101010101110000110011011001110100000000011101010111101000100101100001011000000010000110011010100000111100101101101
1001010000100111001101100011110100100110011010000010100110111111010010011000101110111110001010110001110101100001111011111111111110111001010111111100001101111001
1101011111110011011101111010000110110010111011111110110010100011010110110010100010000000111010100101010001111111001000001100000110101101011110001110111100010011
1000000000011000000001000000110000011000000000000000011000001000010000100110001010101010000010001100010100000000011010100001010000000100000000100000100001000110
1111111111111111111111111111111111111111111111111111111111111111111111111111111111111111111111111111111111111111111111111111111111111111111111111111111111111111
