1111111111111111111111111111111111111111111111111111111111111111111111
0001010101000001010000101000101100001010110000000110000000000110001001
1001000000011101000110000010001001100010000101110011111011101100100011
1101101011110001011111111111100011111011110100011000010001000111110111
1000111010000111010110001100001111001000011111001111010101110010000101
1110011010110110010100101001101000011111010001100101010100011000110001
1011001010110100110101100011111010111001000101110101011111011111111011
1001101110011101100100110110110010001011111101000101001010010000101001
1011100111000100001110011100011010100010000001010101100000110110001011
1000110011101101111100111001001110111000111111110100111111110010100001
1101111000101001000110001011100110011111100000000110101000011011111111
1100001110101011010111011000110011001000110111111110001111001001010001
1001011100101010010100000010011001101010000100011000100100011101000101
1011000110101010110101111111111011101011110101001011110001010101010101
1001101100101010010111000101000011001011010001101000111111010100011101
1101000101100011010001010000011110011001011111001101100011010111111001
1001010100111110011100011111110110111100001100011101101001010010110011
1011011110001100110111110000000100101110111001110101001101000110000111
1001001011100101100010000111101101101000010011000100011101111100111111
1101100000110001001110110001101001000011110111101101110100001001101011
1000101101111111100010111100111011111010100100000100110111011011000001
1110111001000000101010001110001010110000101111011110000011001011111101
1010011100011110111011100011100010010110100001000011111001011000000101
1011001111000110000010111001111111000011111101101011001101011111110001
1001100011110011111010001101000001011010001000101001100001000000011101
1011111010011010110010100101101101111110101010111100001011110111110001
1010000010110010000111101100100100000100101110010101011000010100000111
1010111110010111110100001110110111110101100011000101111111110101111101
1010110000110101100101100010110100010001111001110100110100010100110001
1000100101100100110001111110100101010111001100010101100001000110010101
1011101111001110011100010000101101011100011111000111001111110111011101
1010101100011011000101110111100101000111010001111100011000000001000101
1000001001111000010101000101110001110001000100010101010011111111110001
1111011011001011110101011101011100111101111101110001111110000000011101
1001001011100000010001010000000110001100001001000100000100111101111001
1011101001101111111011011110110110100101101011011111101101100100001011
1000001100111100001110001100100010110111101001000010100000110110101001
1011111110010001100011100001111010111100001101111010111111100010111101
1000010000110111111010111111010010001001111100011000110000101110000001
1101110110100100110000010000010111111011000111001110010110000011111111
1001000011101101100111011111010001100010010001100011011100111000000001
1011011001001001001101001100011100001110111100101001000110011011011101
1001011011011011011001100001001111111000101110101111110011001110010001
1011010001010010001100111111011000001010100100100010111001100100110111
1010010111010110111001101010010010100011110001111000101011110101100101
1010110010000010100011000010111110110111010111010010101001010100110101
1110110110101010110111101110000100010101000100000110001100010101100001
1100100100111110110000100011110111010100011111101111100111010100101101
1001111101100000100110111011010011110110110001001001110001011110111101
1011000100110111101100011000011001100100010100011101011011000010011001
1010010110010010101001001101111100101101000111010000001001111011001101
1010110110111010001101101100110110001111110101111011011101101001101001
1010110010011011100111000110000011011000011100100001110000001101001011
1000011011001000110001110011011110010011000110001100010111100100011011
1111110001101110011100011001010000110111110110111111000001111111111001
1000010100100011000101001100010111100000010010100001111100110000001011
1101000110111001110111100111010010001111111010001111100001100101101001
1001011111101101010000110001111010111100010010101000111101001100111101
1011001011000001011011100100011010011001010110111010000111011110001101
1001101000011111001000110111010011010011010110110011110110010011011001
1101101011110100011110100001000111010110000100100110010010111001001011
1001001001010001001100101101111110010111110111101111011000101101011001
1101011101000101111001100111100011010000010010001000001111100001001101
1001110001011100100011110010001001011111011110111011101100001101100101
1011000111000111101000011010111100010011000000100010100110111101110001
1000011101110011001011111110110111111001111111101110110110100100011111
1110110000011010011110000010010001001101000010101000110100110111001001
1100000111011010110000110111010101100001101010001101100001110001101101
1001010100000010000101100000000100001100001000101000001101000100000000
1111111111111111111111111111111111111111111111111111111111111111111111
