11111111111111111111111111111111111111111111111111111111111111111111111111111111111111111111111111111111111111111111111111111
00000100000000010001011000000000101000000100001000000101000000000011000010000100010110000110000010000011000001100011010001101
10110111101101011100000011111010000011110001100011110001010101011001101000110101000010110011111000110110011101001001000101001
11110001001001001111101110010011111110111111111110111101011111001100111101111101111000111000001111110100111000011101111100011
11011101111011100011000100110110001100000000000100001101010001101110110000110001011101101111100100000001101111111001000001001
10001100100001111010010001110110100110101010110101100001110100100100100110010111000101000100110101101111100010101011101111101
10100110101111000011111100010100110011111110010100111111000110110101101111010100010101110001100000111000111000001011001000001
10110010001000011111000111010001111000000011011110100010011100000101000101010101010100111011001111100010010010100010011101111
10111011111101110000010010011111001111101001001010001011001111111101010100010111110110001010011000001111011111101110110000001
10100011000101100110111010110000011000101101100011111001100100000101110111110000100010101000110011111101000001100000111110101
10101110010100111100101010011011010010111100110110001101110110110000000100011110110110101011100110000101111100111011100011101
10101000110110001001101011000001110110000110010000111001000011111111111101000100100011101010001100110000001110010001001001001
10111011110010100011001001111101000111010011010111110011111001000000100001110001111010001010111001111111101011010111011101101
10011010000111111110011100001111011101111000010000010110001101011110101111011111010010111110100011110000100001011110001100101
11000010110101011011000111101010010000111111110111010010100100000110000001000100000110110000101110100110110101000000100110111
11111110011100000001010100001000110110010000011110011010110111110011110100010111101110000101100000001110011101111110111110001
11000100111001101111010001111101100111000101000100111010100010011010011111110001000010101101110101111011001001100011100011011
10010110110011100000011111100001001100011111110101101000111010110000110000011100010111111000011100000001101011001001101001001
10110000100110111111110010001111011101110001100000101111100010011110100111010001011100001111000111101111101001011101001100011
10100111101100101000111000101100001001100100111011100001101111000010101101010111110001100011110100000110001101001000011111001
10101100001110100010011101111001111011001110101010001011001001101110101001011110000111111001000111111100111001101111110101011
10101101111000001011000001010011001001011010100010111011011101001100101101001000111100011101011100010001101101100110000000001
10100100011011111111110111000110011011010010101110101000001100011001100101100011101110110001000001011011000100110011111111101
10111111001110000101000100011111001001000110101100101111111001110011110101111110000100010111111111011011010110011011000010001
10100001100111010000011110111000011100011100100101100010001011000110000101000011110001010100001101000010010011011010011011101
10101100110011011111110000001110111111110001110101001000101001011111101100011011000101110101100001111111011000010010110000101
10001001111001010000010101100010101001000101011101111101101100000010000110110000011100100101110100010100001111110110011110111
11101011111101000101011111111010000011011101000100100001000111011010111110100111111001101100011111110001111101010111001010011
11001000110101101111000010110010111001000111010110110111110110001110101100101100001111001001000010000111011000010001100011001
10011010100100111010011010100110101101101100010010010100010011101000100001101101101000011101110110111100000011011100111001101
11010010001110000010111010001100000100101101110111000101011001111011110111001000101011111000010000101111110110001110010011101
10010111111011111010001010111111011101100100010001111101001101010010110001101011101010010011011111100000110100111011000110001
11010000000000001011011010000110001000110110111011000001101101000110100100111000100011000111001001110110010101100001111110101
10011101111011111010010011110011111010110000100011111111101001011100001110001110111111111101101101010111010101101101101100101
11010111000011000011110110011010000010010111101010000010001011000111011010101100010001000101001000000100000100001000101001101
10010100011001011111000111001000111111011101001000111010101011110001110010100111000100010101011011110110101111111110001011001
10110101111101011000011100011111100011001001011110101010101000110100100110110001111111110100000010100011111000110000101001111
10100100011001001110110001001010001001100011010011100010111110011110101110111100010011010101101110001110001010100111111100001
10110101001011100100110111101000111011001010011001001010100011000100100000010001000110010111000111111000100010111100000111101
10000111101001110101100001001010010001101110111100011110001001110001101111110111101100110110010011000011111010000110101100001
11110010101111000101111111011011010111001100101001111100111100111111001000010000100001100011111110010110001111101100100001101
10011000101000011101010000011010011110011001100011001001100110000000011011010110111100111011000010111100100110100110111111001
10111101101011110101000101110010111000110011101111101011110011111111110010011110000110101010011010101001110000110010101000011
10000001001011000001101111000110110011100110001101100010000110000010000111001000110010001000111000101011011010011010100011111
10111111011001011011000000011100100110001110111001001111010000111110111101101011111011101111101111101011000010110010111010001
10100000011101110001011111001001101100111100010011011000010110011000100000101000001000111000001000000001101110100110001010101
10101101000100110101110001101011100110100111011011001110110010110011110101101111011110000011101111110100101100101111101011101
10100111011110011100100100111000001100110000010001101100011010100110110100100110000011011110100100011111100110100010001001101
10110110001011010001101110010011111001100111110100001001011010101100010111110011111011000100110001011000110011111000111100101
10110011111000011011001011011001100011001100110111111111110010100111000000011000011001110110011111010010011011001111100110001
10011000100011111000011001001101001110011110100000100010000110110001101111011111001100010010110001000111011010011000001111101
11011110001110001011110011101101011010110000111010001000111110011100101001001011101110111010110101011101000010110010100000101
10000111111000111010000110100111001000000110011011111111110011010110100011100010000111100010010101110001111010100110111111101
10111100000011100000110000110001101111111111010001000000010111010010111010111000110000001111000100100111001000101110000000001
10011001110110001111111110011101100100001100010111011111010000011010001110001111111111111011011110001110011110101011111111111
11001101100110101000110111000100110001101001011100010000010111111011100100100000101000010000000100101100110000100000110001001
11100111001100111010010011101110011101001011001001110111010000010000110001111110000011011011101101100001100111111110010101101
10110010011001100011011001000111000111011111101100011110011101000111111100001011111111001001111000110100101110000111000101101
10111010110011001011011100010001110001000101101001000011000111111100000110100001000101101111000010011111101100101101111100101
10100010100111011110000101111100111101110100101011111001110100001001110011111100010000100001011011110001000110101000100110001
10101110101100010100110101000110011001000110001010001101000001100011000110001111011101101101001001000101011100100010110011011
10000110000101110001100111010100110011011111011010100101011011111111011100100001111000111001101101010100001001110110011001001
11110011110100011111101110010111100110010010010000101101111110000101010001111100010010100011001001011101111011010011000011101
11011000110111000011000000110000001100110110111111100100001100110101010101100111010111101111101011001100001010011001101110001
10001110100001111001111111111111111001100010001001110110101001100101011100110001010010001001001011100111111010110011000100111
10111000111101011100010000000000101011101011101100000110111011101100000110010100010110111100011001101100010010010110010101101
10010011101101001111011101111110100000101010100111110100100000101110110011010111110010010101001111001001000110110010111101001
11000110001001100001001000100011101110101000110000010101101111100011111000010100011111000101100100011011111100011011100001011
11011110101011001011101011101001100100101110111111010100101001111000111111110001000111110101110101111010000110111001001011011
10000011100010011010101001101101001101101010000101011110000011001010010100011111010010000101000100101011010100001100011110001
11111000101110110000101100001100011001000011010000001000111110011011000111000001111011011101011101100010010001100111110100101
10101110101011111110100101011001001011011001111111101101100100110001010001011100101000010001001001001111011011110001100101101
10000100101000000000110111110011101001111011000011001000110001111111011101000110101111110111011011011000011010000100110001101
10110101101011111110010010100110101100001001011001101110000101000011110001010010000010000100001001010011110010111110010111001
10011101001010000010111000101100001110101111011101000011101101011000111011011011111011110101111101010111010110100011110100011
10110001011011010110101110111001011011100100001001111000111001011110001001011000010010000101100001010010010010101000010101111
10100101000010010010000110011111011010001101101011011110001101001000101101001011010110110111001111011010111011101111000100001
10101111111110111111110011000011000010111101101001000110100111101111101001101110010000100010011001010000101001000001110110101
10001010000110001000011011111001111010100000111101010000110001001000100011000110111111111010111101010110001100011111100011101
10111010110010100011000000001100101010001111100001011111111101100010111110011100110000101010000101011111101111011000110110001
10001000111000111111110111111110100011011010101111110000101000111110100000110001100111100011110001001100001001110010010100101
11101011101010110000010100010000111110000010101000100110100010001100101111100111001100001110011011100110101011000111011101101
10001001101111100111010101010110000100101000100010001100111110100101100000110100011001011000111000110011100010011100000001001
11011100101000001100010101011100110111101111111011111101100011110100111111100101000011000010101011111001111110110001111111011
10001110001011101001110101001111110000111100001001100100101001100110100000101101111110011111100001101101000010111111000100001
11101011101001111011100101100100011110100001101100001110001100110010001110101111100010110001001101000100011010000100010101101
10101011001100110000111101110001000110101111100110100110100110011011111100100010001011100100011001011111110010101101110111001
10100010011110010110000001011111010000101000110111110011111111011010001001110110111011001111111011001001010110101101010001101
10111010111111011111111111000101011111100010010000011010001100001000101011000010001000011100001011100011000100101000011101001
10001011101100001010110000010001001000111111011111010010100110101110100001101111101111111001101001110110011101100010110001011
10111000100001100010100101110101101010100000011000010110110010100011111111100010000000001100101101010100110100111111100101001
10001110111100111010101100011100101010001111110011110110011011111000110000101000111111111001101001000101100110110100001111101
11011010000110011010100111000110101011111000100110010011001000011110100110111110010000000011001011011101001100000101111110001
11000011110111001010110001110011101010100010101111011001101111010100101100000011010110101111011000011001011111110100100100111
10011001100101101010011101011000001000101010101100001100100011000001100111111001110011101101001111110011010100100110110001101
10110011001101111011000100011111111110001011101001101110111001101111110000001100111001111001100100010110010001101110110111101
10011110011000100010010111010001100000101001001011000100101101001000011111101110001100110011110001010010110100101010010000001
10110000111010001111010010010100001111111101011011011101100101111011000000100111101001100110111111011010100110000011011111111
10100111100011011000010110110111111100010101010001011000110100100001110101110100100011001110100010001010001100111111000000011
10001100101111001111110010110010000101000111011101110011110110001111010111000101111110011000001010111011111001100010010101001
10111110001101011100011000011011101101110100010001000110100011111010010000011100000100111101111010100010001111101011111111101
10000111100001000101001111111010001101010101111011011100001001000000111111110110110110101100011110001110100010001001100010001
11110000111111110101100001100000111001010001000011010001101101011110001100000010100010001001000011111000111000111100001000101
10011110011000110000101101001101100011011111010110010100111101011011011001011000111010100011110110000011101111100111111111101
10110011000010100111111001011111001110001100011100110110000101000011000011111101110010111110100010111010001011001110000110001
10000111111110111110001011010010011100101001001001110111110101111001111110001001100110100010101011100010100000011010110011011
11010110100010110000101000000110110001100011101011000011000100001100100000100011001100001000101000001010101010110000011000001
10010010101000100111101010111100100101001111001011011110011111011110101111111110011111111101101011111111101110100111111111111
10111010001110101110101110001101110111011010011001001100110001001011100000110000110101100100101110000000101000101100010000001
10100010111011100010100111100100011100010000111101011001111011100011001110011010100000110110100000111110101010100101000110111
10111010100001001010110010110111001001111111100001010011000010111001101011001110111010000100111111101010111011110111111110001
10001110110100011010011010100101101101000001101111110111101000011100100011100100001011101101110000000010011001010010100011101
11100000100111010010111010001100100100011101001000000110001111000110111000110101101001001001000111111011001100011010001000001
11001111110110010110001011100110110110110100011111011100100001011100001110010111001101011011011110011011101110111011011111111
10011100011100110010100000110000010100100111110001000110111101001101100011010010011001000011011000110000100100100010000010001
10110101001001111010111110011110110110110000000101110011110001100111111011011011001111111001010011110110110101101110111000101
10110001100011001010110011000011100100100110110100111000100100110011001001011001100110001100010110000011100101001000101111101
10011101111111101011100111111000101101101110011110011110101111110110011101001100110010101001010000101110001100011011100001101
11001000100001101000101100101110001001001011000110110100101100010000111001100110111000101111111011111100111001110001001101001
11101010001100001010100110000011111101100001101100100001101001011110001011111100101111100100001110000001110011011101011001011
11001111111111111110110000111000000100111111100110101111000011000111101000001110100000110101101000111111011010001000010011001
10011100010110000110100111101111101110010000110100101000011111110001111111100100110101100100100011100000010010101111111001101
10110001010100110100101101000000100011011010100110101101110101011100110000110110100100101110111110101111000110100100001111001
10000101000001100001100000011010101000000010001100001000000000000110000110000000101110000000100000000001010000110001100000010
11111111111111111111111111111111111111111111111111111111111111111111111111111111111111111111111111111111111111111111111111111
