1111111111111111111111111111111111111111111111111111111111111111111111111111111111111
0010000010000000011010000000001000100000000010100001100100001100100000000001000100011
1011011000111011000011011011101010001111111000001100110001100101101111011100010111001
1001011111110011111010001001111011011000001111111110111100110100001001001111110011101
1101000100010110000011111100001011001011111011000010000110110101111101101000011001101
1001011101010111101000011001011001101000100000010111010010010100001000100011011100101
1011001101010000111111001111000011001101101111110011111011010111101011111111000110001
1011101001010110010011100001110110011100001001011001101001110000001001101001010011101
1010111011011111011001111100010010110001111100001100001100011011111100000011111010101
1010000010000011001100000111011110011011000110101111011111001001000101011110111010101
1011101111111001100101110001000011010010010100100011000011101101010101000000010010101
1000100100011100110100011011111010010110110101111001110110001000010111101111010110101
1110110001001110000110110001101000110100010001000011000010111111110000100110010010001
1010011011100011111111100100101111100101011111111010011010000010011110110100111010111
1011001110001010000000001110101000101111010110110010110011111011000100011101100010001
1001100011111010111011011100100010100000010100100110011110010010011101110001001111011
1011111010000010011011110001110111111111110001101111000010110111000101000101011001001
1000001000111111001000100100000110001101000100100001010110000101010001011111001101101
1101101111100001101110111111010100100100011101111101110010111100011111000011101000101
1100111100001100101010001010011101110001110000101000111000100001110001111000101010001
1001110001101001101011100010110000011100100110001011101111111011000100001010101111011
1011100100101101001000111010011011001110101111111010000001010001101111101110100001001
1000101110101001011010011011110011100100111011000011010111000111001010001000101101101
1010000111101101010011001000110110111101100010011110011100011101101000111010111101001
1011111100001001011010011110010000010000101010110011001101110000001011110010011001011
1110000001111011001011010011000111110101101000011001101000111110111010100111010011001
1000111111001011101010010111111100010101001111111100001011101000101010001100010111101
1101100000011010100010110100100001000101011000010110111000001011101011011001110010101
1000111010110010111110110001101111111101011101010000011111100010001011010011011000111
1010110010000110001010011011000110001101000001011011010000111110101000010111011110001
1010011110111100100011001011010011100101111111001110000110100011101111110001010011101
1011000100001001110111101001111000110100000001100010111110101010000100111100000110001
1011110111101100010010001100101110110111111101111010001000101000110110100111101110101
1001010000100111110110111110000010010011000101001011101101111101110110001110100100101
1101011110110000000010010111101011011001011101011001101000100001000011011000110101101
1000011010011111010111000100001001001100000001011100101110001111011000000011100101111
1111000011000101011100010001111111011111101111000110100011111001001111101001001100001
1011111011110100011001111111100001000011001001110010101001001101101000111011011101011
1010000010000101110011100011001101011001011100010110111101100000001010001110000111001
1000111110101111100111001000011101111101011001000010011001001111011011100100111100011
1011100100111000001100011101110100110001001101011111001101100001110000101101100001011
1011001101100011111001000111000110011011100001110001101000111100100110101000101101001
1001011100110110010011111110010011001010111100100100101010000111101111101011101111101
1100010001100000110110100010111111101010000110101110001111110110001101001011001000101
1111010111001110010000001010000010101011010000100011111000110000101000011001011010111
1011010001100011111101111010111000100010011111110110011010010111111011001011011010011
1010011100111001100111000011100010111111010000010011010011011100011001111001000011001
1010110110001101001100010111001111100010011011111010000110011001001100001011111111101
1010100011101000011101111100011100001110111000001000111110110011100111011010000000101
1010101000100011111001011001011001011100100010101111101010100110110011010010111110101
1010001111110110000011000011110011000101111110111011000010001100111001000110001010101
1000111100011100111111101111100111010101000110000010010111111110001101110111101000101
1011100001000110101100000001001100010100010011101011010101001100100101100011001101101
1001001111110100100001110111011101111111111001101001110000011001110100101010011001001
1101011011010001101111010010000100011000101100101100100101011011010110101110110011011
1111010000011111100110011000101110110010000110101110001111110010010000100100100110001
1000010101000110110010111110111000110111010010001011101100000111011111111101110111101
1110110101110010011010000011110011100101011111111011000110111101000101010001010000001
1000100100011010111011111010000111001101001000000000011100100101010000000111011110111
1011101111011000110001100010111101011101100011111111111001101100011011111100000010011
1011000101001111100100101010000001000100111110001000000011000001110010000111110111001
1001110101100001101110001011010100010001100000101011111111111011100111110100010101101
1101000100111101000111111001111111110111001011101001011000001111001101100001010000101
1101011110110100011100001100111000011100011000101101010011100100011000101111011011101
1001011000100111111001011110010011000001001111100100010110110001110010000011001001001
1011000010001100001011000111110111111111111000001111000110011111000111011001101101011
1011110110111001100001011100010110110000010011011001111100110001101101111100100001011
1000011100100011111111001101000010100101011011001011000001100100101000110110111101001
1011000101101110000001101001011000101111011001100010011100101111101110010000100001101
1001010100100111011101001011111111101010001101111011001101100000100011010111111111001
1011110101110010011001100000110001001000100100101001101000101110110110010001000001011
1001000100011010110011001111100101011111110110101101001011101100010010111011011101001
1011011101110010111011011000001100011000100010100101101000100101111010011011010101101
1001000111000110001001110011111111001010101010110000001111110100100000110010010100001
1101101110011111101100000111000100011010111000110110111000100110001110100110110111111
1111001000110000100111110100010001110010001110011111100010001111111011101100100001101
1110011011111110110001100111111111000111100011110001101111111000100001101001101100001
1100110010100000011100101110001100011110111000110100001000000010111100100011001111101
1001100110001111001110111100100001010000001110010111111111011110000110111110011001101
1011001111101001100010000001111111110101101011000110000010010011110100010000111100101
1010011100001011111011101111000000100101001011111100101011011000010001010101100110001
1000110001111011000000111101111010110101011010000101101010010011111111011101110010111
1011100111010001011110011000001010011101001000110111001011010111000010000001000110001
1000001100000100000011000010100011000001100010100000011000010000011000110101010000100
1111111111111111111111111111111111111111111111111111111111111111111111111111111111111
