1111111111111111111111111111111111111111
0010000010000100010000010100100000010001
1011111000111101010111000110001101000111
1000011110011001010011010111100101110011
1111000011010011011001010000111101011001
1001111011010110001101011110110001001101
1011011001010010101101010110100111100101
1000001101000110111001010000001100001101
1111100101110010100011011111111110111101
1000110100011110001111000110001010000101
1010000101000100111001010100100011010101
1011111101110101110011010101101000011101
1010001111010100000111110101111111001001
1000100110010111110100000100110001111011
1101110000110011000101111110000100001001
1000111011111001111101000010111111011101
1011101001011100001001011010000101001001
1000101100001111100011001011110101101011
1110000111100100111111101111010001100001
1011110100110001100001000101010100111111
1000010101100100110111010000011110010001
1011110101001110000010010111001011000111
1000000101011111111010111101100001110011
1011111101000100010010001000111100011001
1010000101110101010111100010110111001101
1000110000100101000010111110010001011101
1111111101101111111110000011000111000001
1000001000101100010000101001110011111111
1101100011101001010111101100010110001101
1000101010001011000100100110110100100001
1111111010101011111110110011100101111011
1100010010111001100000011000001100101001
1001011110011100110111011111111110001101
1011000011010110100101001100000010101001
1011111000000010001101100111011000111011
1000001110111111111000110110001011110001
1101100111100000001011100011111111000101
1000110011001011011000111011000110011101
1010011000011001000010000000010000110000
1111111111111111111111111111111111111111
