11111111111111111111111111111111111111111111111111
00000111000010000001100000000001000001100000010001
10010010011000111100110101011111011100110111000111
11111011110010110110011101110001000110010010010011
10101000110110100011000001000101110111010110111001
10001110011100101001101101011100100101000010001101
10111011001101101101001101001110001101111111100111
10100001100100001001011001100111111000110001110011
10101100110111111011001111110001010011100100011001
10100110010001000011100000111100010110001101011101
10110110111101101110111101100111000110111111010101
10110010001001000110000101001101110010100110010001
10011011101011110000101100011100011010110100110101
11001010101001011111100110110001001010010101110101
10011000101101000000110010110111101011010100010101
10111101101001101111111010010110101011010111000101
10011000101011000011000011010010100010010001111101
11001101101001101000011111011010111110110100001101
11100100100011001011110100001000001000100111011001
10110110111110011000000101101011111011110011000011
10000010101011111110101100111001100010011001111111
10101010000011000010111001110011001111001101100011
10101111111000011011100011000110011001101100101001
10101100001111110000101111011100111100000110101101
10111001100101011110100101000110100001110100100101
10110011101100010000110001110010111011000101110101
10100110001101010111111101011010001111101100111101
10001111011001000100001100000010100110000110011001
11111101011011111101101001111111110100110111010011
10000100010010001001001101000001100110010010010111
10110001010110100011011001011011001100111010110001
10011111110011110111001101001010011101101000100111
11000000011000010101100101101110110000001111110001
10010101001111000100110100001000110111111000111101
10111111100001111101100101111011100000110010100001
10101000001111100100110100100010111110000110111011
10001010101000110001100111101110000011111110011011
11111011111010000101001110001100101010000011001001
10000010000011011101011000111001101011110111101101
11011010111111001001000011100011101001000011001001
11001110100001101111111110001111001100010110011101
10011100101100101000010000111001011111110010111101
10111001101001101010110111101101001000011010101001
10100011001111001010100100000001101111001010000011
10101110011000011010001111101100100011100011111001
10000011001011010011111100001110111000110110001101
11110111011011110111000001111010001110011100100001
11000010001001100001110111000011101011000101111111
10011000101100001100000100011000000001010000000000
11111111111111111111111111111111111111111111111111
