111111111111111111111111111111111111111111111111111111111111111111111111111111111111111111111111111111111111111111111111111111111111111111111111111111
000100010000000001010001101000000001101010100000000001000000000000000011000010110000011000010101101100010011000100011000000010000000000000011000000011
100101011101110111000100100010110100001000101011111111011111111011111001011000010111001011000001001001000110010001001010111011111010111111001011011001
110001000100100110010111101110111111100011101000001000001000011010001101001111000101101111011100011011101100110101111010011000001110110011100001011101
111111110110101100110000100010011000110111001111100011111011010010100001100001101100100100000110110010001001110101000011001111100010010110111111001001
100001000100101001100110111011000010111100011001111111000010010111101111111111001110110110111110110110101111000100011111100001111011010100100011101101
111101011110100011111110010011111110011001111101000101011110110011000110000001101000110010100010100010100011111101110000111101000010000101101001100101
100001000010111111000011000110000111001011010000010001001000111001110011011011001010011011101010001010111000011001000110001001011111110001001100110101
101111111010100001101001101110110011100000011010111101101110101101011001010010011011011010001011111010001111001100011111011011001100011011011110010101
101000010010101011001101000010111000111111001110000100100100001101001101010110111001010011011000010011100101100111110010010011100111000001010011010111
101011000110001001011101111110001110011001100011010111110111101001011100010100101101000111011111011000110100110101011000110110110011011111011001010011
101001011111111111010001000010100011001100001001010001010000101011000111110101100001101110010100001101110101100100000010110100111001111000010011011001
101011011000000010011011011011110111100111111101110100011110100001110000110100101011000000110001101000100100110111111110100110011100001011111011011101
100001110011011000110001011000000101110010001100100110110010111111100110010110111110011011111011001110101110010100000011101111000111101010001000001101
111100100110011111111101001111110100011000100110111110100110100011001111000100100011001110001111100010100011000001111001100111010110000011100011111001
110110101100110001010101101000011101011111110010100000101110101001111010011101101001100100101000111011110111111111001100110010010000111111001110110011
100010111001100101000100100010110001000001011010001110100010001100000011001001001101101101100010001001010000011001100110011010110101100001011000000111
101110100011001111010110101110000111111101001011101100101011111111111001100011011100111000101110101100011111001011101111001011111111001101001111101101
101000101110011010010000100111111100010101100000111001111000100000101100111001000110010011111100100111000001101011000011101000010001100101101000000101
101011101100111010111111110000100001000100110110110011010010001110001110001111110011000110000110110101111100001010011110001011000100110100000011110001
101010000110001000100001011010001101110110011110010110000111111011100111100000011001011100110011110100110111111000110000101001111110011101111110011101
100010110100100011110100011011111111000011000011010011010100011000110000101011001101111001111000010110010000001101100111111101000011000111000111010001
110111100101110110000110110011000110011011111010010110011111000010011110111011011100100011001111010011000111011000001100010100011011101100010011000111
100001001111100100111110010110010011110000110010110010110001111111000010011001001001101110011101011010010011010011111101000111111010001110111001110101
111101100001001101100011011100111001100111100110111010100100110001010111001111100011001010110101001011011001110110000001110001100010100100101100100101
100000111101101000110111010001101100111100001110010000101110100101010001100110111110011000010001101010001100100111101111011100110110110101100110101101
101111100001000011110001000111000110001001111011011101101010101101111011110010100010111101011100100011011001101100001000010110010110100101001110100101
100010001111111110100101011101010111101011000001001101001010101001000000111000001110101101001101111110010011001001101101000111011100111100011000110101
111000111101010000110101110100010011000011011101100111011010001101011010001111011100100001100000100110110110011100111001110000010001110001110011100101
101111100000010110100100100101111001111110011000110000010011111001001111101000010001110100110110110010110100110110001011011111111011100111000111001101
101000001111000100111110001101011100000000110010111111110111000011101100001011110111000110011100011000010101100011101011000010001011001110011101011101
100011111101111101110000100101000111111011111110101010100000011110100101111001010001110011111001110010110100101011001000011010101010011010111000000001
101111000101100100100110110101110000011011000100001000001111111000110101101100011100011000010011000110100110101000011111010000101010110010001101111111
100001101100001110001111100100111110110010010111111011111100000010100100000111001111001101010111101111101100101111111000011111100010000111100111100011
111101001101011111111011001110010000100110110000100010110001011110110111101101100101100111010011000101001001101100001101110001110111010000110010001001
100001101001001100000001011011000110101110111110001110100101001000010000111001110101110001011001111100011011000110100001000100100011111110011000111101
101101001011101001111100000001111110100010100011111000111101101111010110000011000100011101001100000001111010010100101011011110111001100011011111101101
101001100011001011001111111100001000110110111000000010001000100101011111110110011110111001100111111101100010110111111001010010011100101000010001001001
101111101110011010011000110111011011110010010010111111101110110101001000000100110000010011110001000100101110100110001111011011010001101111111100011011
100001001000111000110010010000010000010111011010110000100100010101101101111101111111010111011101010110100011101100100011010001011111000000000001110001
101101101011110010100111011101110111110001010010011101110101110100100001000001000110010010000001010010101001100101111001000111000000011101111111000101
101100111000000111101101000111100001100101011111001000010100010101111101011111010000111010110111011011111101001100001101110011111111110111000011101101
100110011101111111001001010011001011001101000111101101110111010101100001011000011111101010011100001001010000011110111001010110000000000100011000101001
110011000100000010011011111000011110011101110011001001000001110100110111001111000011001011010001101100000111111000011101000100111110101101110010001011
111001110110111110110000101111110100110000011010011100011100000110000001100001011000011010000111111001111101000011001101011110100011100100100111111011
101100010100010000100110000000000101110111111010110001000111111100111100111101001110110011011100001100000001011111111001000011101000110110111110010001
101110110101110111101111110111111100010110000010110111110100010001110110100001100010010110001001100111111101010000100011111000101010010010100011000111
100100100101100100001000010010001111011100111110010100011101010101100011101111001011010110111011110110000111011110101110001110101111000110001001101101
110101101100101110111110111010100011010001100011011101000001011100001010001000011111010011100010010000101100010000100111101100001100011111111100100101
100100100111101010100110010010111000010111110110001001111111001111111010111010110001011010001111011111100110111011110000001001111001001100000110110001
101110110000100010110011000110101111010001100100101011010101100001100010011011100101001010111100000010110010101000011011111011100011100001110110011101
100100011110111010011000010100100100011100110101100011000000111101001111010001101101101010100001101000111000100011001000010010111110111111000100110001
110001110000110011011101111101110001110110010001111110010110010001111101011111001000001010001111111110011111101001011110110110100010010100011101100111
100100010111100110001001001101000101000011011011010111111111010100100001001000011111011011101000000011010001111111010100100100101011000101110101101101
101111110010001111101101101001011111111001001001000100000100010111101011101101110001001000001011110110000100000000010101101101101001110101000100101001
100011000110111011001000001011000010100011101100010101010111010110001001100001000101111111111000100011111111111111010100101001101100010001110110101101
110110010110100010011111011001111000001000101111110101010000010010111100110111011101100000001110111001100000000001010110100011000111010111000100100101
100100110100111000110000001100001110111111101000010111011111011000000110000010010000101111101000101100110111111100000110101110011100010010011101110101
110101100101100010011111111111100011100001101011010001000010001111111111111110110110001000101011100110011110001001101100100110110110111011001000110101
100101001100110111001100001010111010001100001001011101111011111100001110000100111111011010001010001111000000101011111001101100100000011011011011100101
101101111110010110011001100000001000111111111101000101100010000001100100110110000111001111100011011001111111101000110011000101101111110000001000101101
100100010011010011110011110101111111110010100001110100001010111111110001100100110010011000111111000011100000101110100111110101101100011111101110101001
110111000111011000110111100100110000011000001111100110111010010000011111101110111010110010010000011110001111101000101101000100100101000000111100101101
110101101110010010010111001110011011011101101000001111100011010111000001000010001011100111010101111000111000001011101101011110110001111110000001101101
100000100100110111000010011011001010010001111011111111001110010011111101011011111011001110011101000010100011111000100100010000011111000011111111100101
101111110101110011110110111011100011010100001001100110011011011010000101110000001000011000110001011110101110101111110001110111110110010110000000110001
100010000100011000011100101000111110010101101011001100111010001000110101100111101101110011100111000100101000100000011101000100000100110011110110011011
110110111111010011110001101010001100110111001010011101101010111111100100111100100100111010001100011101101010101101000101011110110001111000100011010001
110010001100011110000111001011101001110100011000111001000010010001110110001110110101100011011001010001101010111001110101001000111111011110111110010111
100111100111010000111100011010101011000101111110010011011011000100100011101000100101001010000011010111000010010011000111101011100010001010010000110101
110100110010010111100001000010100010011100000011010111110011111110101111001010101111011111101110010010011111011011010011001000001011100011000111100101
100001111010110101101111111110111111001111111001110101000110000110000010011010001000001000100111111000110000000010011000011011111000110111101100001101
111101001000100100100101011000000001101000001100100000010100101100110110111011111011111010111100001101100111111111001111111011001110010010101001111101
100100011111101110110001001011011111101010111110101111011101100110111100110010001000010010010001100111101110000001100110001000011011011010001011100001
110111010101001010111101100001000000001110001100101011110001110011100001100111011011000111000111110000111010111101001100101111010001001000111000101101
110001000000011000001101001111111111111100100110101010000101011001101111001100010011111101101100011010001000000101101001100011000111101110001110101101
100111111111110011011001011100001000000101110010100010111111011100001001011110110110110000111001001110101011110100111011111001101110100011101100100101
101100000110100110001011000110101111010100011010110110100001001111111100010000010000100110011011100110100000111110001000001101000100111000111001110101
101001010000101111011011110100100010010111110010100010001101101000011001111011011110101111001000110010101101100011101111011001010001101110001011000101
101011011101101000011001100001101000110001000110001111111100101011000011000011111000001011101011111011111000101001000000001011111101000011011010011101
101011110100001011001011001100111110110100010010100000000110101001111111011010001111111001001001100000001011101101110111111000011001011001001010110001
100001100111111001101001111110100011100110111111111011101100101100101001011110100100001100011100111111101000100100010110001111001011001011101000110111
101111001100010011001100011011101000111111100000110001111001100110001100010000110001011001110110001011001010110111010010111001101001101011001111100001
100000011001000110011111000000001010001100001101100100100011001111100111000111111111000011000011101000011111100001011010110011001011001010011100111101
111101111011111100110011111111111111100101111101001101101111011000110001110001000011111111011000101011110001101101001000100110011001111010110001100001
110101000010000101111000000000110101110001000101111000101001000010111100100100011010100001011011101010000100111001101110101100111100100010100100101111
100101011110101100001110110110010100011111010100001010101101011010000110111110110000110100001011001011011110000011100010000101100110101010001101101001
101101011010100111100011100011110001010000011111101110100100001111110100100011100110011101111010011011010111111110111011111101101110101111101001001101
100001001000110001111001101011000111000101111000100011110110100111000101101011001111001111100010111000010000101000110010001001000010100010001011011101
111011101010011100011100111010011101111100000010111000000100110010010100001001011011100001001010101111111010100010100110100011011110111010111011010001
110001101111001111001110011010111000000111101110011111111111111110110111111101111010110100011110101100000010001010101100111110011000100010011110010101
100100100001101011100011001010001111010110100111110001010000001000110100000100100010111111110000101001101110111110100110100111000011101111000010110101
101111111011101010111001101011101000010000110001000100011011101101100101111110001010100000011101100011100011100010110010101100011111000001010110100101
101100001000100000010011001000000010111110111011011101000010000101001100100011111010001011001000110110110111001010011010100101110001011011110000110111
111001101110111110110111011111111111100011100010011001101111110001011001101000011010101011101101100100010001011010110010101101000101110010111111110001
100011100110010000010001000010000000001000001110110011000100011101000011001111010010111010100100101111011011011010100110101001101100100110001100010101
101110110011010101111011111010111111111111101100100111111101000111110110011001000111100010110110100001001001001011101110101011000110001100100001011101
100010011001011100011001100000010000010001100101101101100001110110110100111101111100001110000100110100011101101011001000100011101111011001101011000101
111011001101001001001100110111110111010100110100100101001111010010100101100001000001011010111101111111001000101000011011110110100001110011001001110001
110010011101101011111110000011000101011110000110110000011100011010101101001101011111011010110100100001111011101111110010010110001100000110011100111101
100111000101101001100011111001011101001010111100111111110110111010101001011101111000010010000110001100001001101000010111010011111111111111010110010001
101101011100001111001001101101001001100010101001100011000000110010001011010100110011110111110111111101101100000011010010011001000000100001000011011011
100001000111100110011100100001101100111010001011001001111010010110101001010110000110000010000101000111001111111111011010111101101110110101111110001111
101101101110001100111110111011101110001011111011101100010010110011101100010011111111011010111100010001100110001001001010000000001010000101000010100001
100100100010111001101010001110101000101001000010001111000110011001111111110111010110001010001101111011110010101011101011110111111011110100011011110111
101110110110110011100011101000001101101101011110100001111111001100010000110000010000111011100101001001011000101011001000011110000000011111110000110001
100010010100010111001000100011111100101101000010101100000001100110110101100110110111101000110101011100001010101010011011001100101111001001011110011011
111011010001010010011010111111000110100101111010111111101011111100100100001100010011001010110101001111101011101000111111100101101001101101000011011001
100011011011111010110010000010010000111100001010011000101001000001101111111101010110011110010101101000101010001011110000110100101100101001010110001101
101001001010000010011111101000111011100001011011000010101101011101001000000101110000110111000100100010001010111001000110010101101110000011010011100001
101111101110111111010000101111100010001101001001111110100101000111011111010100111110110001111110110110111010001101011111010111001000110110011000111011
111000001100100101110110100000110110101111111101100011110101101100011000010110001010100101100010011110110011101001000011010001011111110100111110101001
110010100101110000000110110111100100100010000001001011000100100110110011010011011000101100001011001010011000101011101110011101011000011101110100001101
100111110100010101010100011100001101110110111111011000010101101100100110011001011011100101011001101011001111101001001100110001001101001001010101111001
101101000111010111011111001101111100011100100010001111111100100001110111111101000001110111011011001001100011001101011001100111101001101011000100001101
100001101101010011000011100001000101111001111000100100001001111111100010001101111111000010010010011011111010011001001011110100101011001011101111100101
101100111100011001011000110111010101100011011011110101100011000010001000100111000101101110111000111000110000111011101001100110100010011000101000110001
100110010101111101111101111100010101001110010001000101111111101000101111110110010001000110101111100010011111100010001011001110001110111110001010011111
110011010001001000110100100001010001011000110111011100100001001111111000010000110111011100101100001111110000110111011000011100111010000011101111000101
111001000111100010010110101101011011011101100010010110111011011011010011111101111100011001100001100000110110100110011111110101101011111000100010010001
101101111101001111000100100111111110010001101110110010010010010000000110000100001001110011001111111110000010001100110110000101000000001101111011110101
101001000001100111111101110010100000110100001100100111011010111101010010101101111011010110011010100011111111111001100010111101011111100100001000110101
100011010100110010100000111000101111100111111001101101001010001001111010101100100000010010110000101000110000011101001000010001010000001111101110000101
101111110110011110001101101110100000101100010011000001101011101100001110100110001101111010000110101101100111000001011111010111110111100110100011111101
101010100011001000111000000010111110101001010111101100101010101001100000110011111111000011111110111101001101111101011010010100010100110100101000001101
100010001111101101101111110110000100100011010100000111101000001011111111111000011000011010000010000101011000011001001010110101000101100101111010111001
111010111010100001000010000010110101111001110111101110001110111011010001001101001110111110101011110101011010110011101010100101111100101101010010010011
100000100000111111011000111011100100011100110000100000100010001110000101101001111000101100101110000100001010100110000010101101000110000001000111010111
111111101010001001001111101110001111010110010110111111111011100010110100001100001011100001100011011111101010101110111110101101010111011111010011010001
110001101111100011100001001000100010010111110100110000110000111000011111100101011000111100110110010110000011100011100010100100010001000100011001111101
100100001000111001111100011011111010110100011101100110011110011111111000110101001110011001100010110010111001111011001000110101111101110101111100100001
110111011010011111000101110010001010110001001000101111010011000110001101110101101011001100101010011010001100010010011111100101011001100101101101101111
100100011011000010010001000111100010100111101110000110011001110000101101100100100011100110101111001011100111110110110000110100010011001100101000100101
111101001011111010111111011101001110001100100100110100110011011111100101001101101010110010100101101000110100000100000101100101110111011110101011110001
110001101010010010010000010000011011111110110111111101100110001001110101011111001010011010110001001010100101011111111100001111000100000110100010011011
100101101011010110110111111111000000010000100100010001001110100011000101000110011000110010111101011010001101110001000111100001010101111100101111001001
101111001011010110010010000001111101000110101101000111100010101110011101101100111101110110010101010011111001100100010000111100010111000001100000011101
100001111010010011011010111100100001111111100101111101001000111000110000000001100111000111010101010110001101001111111110000111111110011111111101010001
101100100010111001001000101110101011100000110101000101011110011011100101111111110110011100010100010110101001011000000011101100001100110001010001110111
100110001110001101101111101000111110101101110001011100010011001010111111100000000100110101110111110000111011011011111001000110101001100100010111000001
110111111100100101101000001011100010001100011111000001111011100010110000001111110001100101000001011011100010001000001100010000100011001111110110011111
100010011001110101001011011000001000100111000001111011000000111110100111111000111111001100011100011001101111101101111111111101101001101000100100110011
111011010011100100011111011110111111111100011100110011111010000100001100000010010110011111110111001100100101001111000000100100111111100010101101111001
101000000110101111110001010011110001010001110001100110001111110001011111111010110000110101000001100111110001011000011110101110100000110110001001001101
101111111100001000010100011001100101000101100111001100100000110111010000011010100101110000010111110000100101011011110010100000101110011100111011101001
101000001101111011010111011100101100011111001100011001111110011110011011000011101100010110110100011110101101000010000110111101101011001110001000000011
101011100001000010010001000110100111110001111001000011000111001000110001111110000101110010011101000100101101011111110010000111001011100011111111111001
101010111111101111011101010010110110000100010011111111010011101101100111000110111100111011011001011101111001001100011011110001011010111000100000001101
100000000000001000000001011000010000101101000110000000011000000000110000010000000110000001000011000000000011100001000000010100000000001010001010100000
111111111111111111111111111111111111111111111111111111111111111111111111111111111111111111111111111111111111111111111111111111111111111111111111111111
