11111111111111111111111111111111111111111111111111111111111111111111111111111111111111111111111111111111111111111111111111111111111111111111111111111111111
00010000000101101011000110010110001100001000000100000010110001100001011000000000011000000000000000110100001000000001100000000000010000011100000110101000001
10011101010100100000010011000000101001100010110101111000100100001011000011011111110011011111111110000101101011111100101110111111011111001001011100001110101
11000101010110001110110110011101111011111110011100101110001111011010011111000110000110010110000111110101001000000110101000100010000001100011000001100100101
11110111010011111000100100111000110010000111001110100111111010010010110001010100111110110100110000000001011011110010101011101011111101111111110111110001101
10000000011001100011101101101010100110110101101000110000000010111110100101110001110000100001111111111101001011011010101010001000100100000000000100011111001
10111111111100101110000100001011101110110101101011100111011010101000110100111111010111110100000100000111101001001010101000101110110111111111111101000010011
11100000000110100011110111011000101100100001001001110010011010001011100110100000010100011111111101110010101100011010111011100010110000000000110001101010111
11001011011110111001000010001110101001101100011100011110110011011000111100001011110001001010000100011010101111110010010000111110011101110111100101111010101
10011001000010001101111110111100101011000111111101001100111111011110000101011000111111101000101111011010100000000111011111100011001000010000001100001110101
10111101101011011000000100110001101011010100011001100001100001000011110111110010100000100011100000010010111111111100010000101001101011011111111111100100001
10001100101110001010101101100111001001111101000011110111001101010110010000011110001111111111001111110110000001000001111010101011001001111000001010001101111
10100110100011101011101101101110011100001101111110011100011001110000111110111000111100010001101100000111110101011111000010001000011100110010100010111001011
11110011110110101010001000101100110111100001100111010001111011000110001010010010011001000100100101110100011100001010010111111111110110100111111010000011001
11011001100000101110111011100101100000111111001100000111010011101100100011000111010011111110110101000101001111100011110100001000010010110001100011111111101
10001100111011100110011010110001001011101010011001111110000110001001111111111111010110000010010101111101100110111000100101111011000110011011001001000001001
10100110001000110011000010011111101000000000111011101000111111101011000100100010010011110111010100000101110010000010001100001011101111001010011011011100011
10110011101110011001111010111000111110111011100010101011110001001001010001101000111001100010010111101101011011010111011111100000100001101010111110001110111
10011001100011001100001010000010011100100010001010001000000101011111011100001011101100101110110100100000011001111100010001111101111100101010000100111010011
10111100101111100111101000111111001001101010111011011111110100010100000111011110000110101100100001111111001100000111110100001001001110001011101101100011001
10111110100110110010101111100011101011001010011110000100010111110001111110001100110110101001111100000001100111110100000111101011101011111110001000001111101
10011000110000111000100000101110001001011011000011110001000100000111000011100101110000101011000111111111110000100101111110001001100011000110111011111000001
11001101111110101110111110100110111101011011111000011111111101111110011001101101011111100000010011000100011101101100110100111100001000010010100001000011101
11100111001100000110000110110010011001001001101111000010000001000010111100111001001001001111111001010101010000100101100101100111111111111010001111011110101
10110100011001111100110010011011010011101100100001111010111111011110101110000011100011011000101100010001011110101100101100110000000000001011111000010000001
10000101000011011001110111001010010110100110101101011010010001000010100011111110110110001010000111111111011000100110001110011011101111101010000011111011111
10110001111110001011000011101000110100110010001000010011010100011010111000000000000100101011011110000011001011101111100111010000111000111011011110110010001
11100111000110101001101010001101110001111011111110110111011101110010011111011111101101111011001000111001101110001000001100011010110010001011000110100111101
11001110011100101100111110111001010100010011000010010001001111000111000010001000000100011001100011101101001000101011011001110010100111011010010010001100001
10011000110001100110100000100011000110110110010111011011100000010110011010111011011111001100111110001001011011101001110011010110001101000011011010111101011
10111101100111110110001111110111111110100111110010001000111111110011110010001001110001100110010000101011000010001100100110010111111101111110011010000111011
10110001001100010011111001100101100010101100000110111101100010000110000110111101100100110011000111101001111110101110101100110100000000010000110011110001001
10011100011001011000001100110001001011101001010010001101001010111100111100010101001110011001111110101011000011101000101110010110101110110111100110011101101
11011001110011001110101110011101011011001011111111011001011000010001110110110001011011011011000010001000011001111011100111000011100010010010101111001001001
11010011010111100011100011000000010010011000010000001011001111110111010100100101011001000000011010111111111100001001110001101000101011111000101001100011101
10010111010101001000101001111111111010110011000111111011101100010001000101101101001011111111111110010010101111101011011100111010111000100011101011001110001
10110000010001101110101101000011000000110111111100011010100101011101110001000111100000100010000111011000101000001001000110001110110010101110001000011011011
10111111011100111000100100011001101111100100100101001000110101001100011111011110001011101010110011010010101011111101110011100100011110000010111110110001001
10100110001110110011110110111100111000001110001101101011110101100101010001000000111110001000011001011010101000000000011000110111000011011010100100011100011
10110100111010011010010110001110001101111000101100100010000100110111000101011111100100111111111101010010001111111111001010110011111001111110110001000101011
10110001110011001011000011101011100101011101100110111010111110110001110101000101001101100000011101010110100000100011100010011010001100110000100111110001001
10100101100111101010011111001000110100010001110010011110100010010100011101110000011100101111001001010111110111101000111111001000100110011101101100011111011
10111100101101001011010000011011100111011011011011001100110111011101000001011111000110101011011011010000010010001110101011101111110111000100111101001101001
10000110000001011001110111110010001110000010001011100001110101000111111111010001110110001000010001010111011110111100100001100000110101110110010001100101011
11110111111111001100110001100110111011111111100010111111000001110001101000000101100011111101110111010001000010010101110100101011100101010011000100110101001
10100100000011011110010100101100110010000001001110100011011100010100100011110111001001100100010001010111111011010000010110001110001100011001101101110101101
10001101101001011011011110101001100110101111011100001000010111011110101001000010011100001111011100010010001001011111011100111100101001001100111111000101101
11011001111101001001010000100011001100100010011001011111110001001000101101111010110111011010001111111000101011000011001111100001111101111110000011011100001
10001100110101101011010111110111101001111000110011000001000101101011100100001110110010010000111000001111111011111001100110001111000100000011111000010101111
11011110010100001000010001000011001011001111100111111101011101001001110101100100011000110111110011100001100010001101110100100100010111101111001111110101101
10001011010111111011110101111001100001100010111110001001001001011100010111001101001111100100011001110100001000111101000101101101110000100000011000010100101
10100011010000110010010100101100101111101010100000101011101011000111010011100001111000001101001101010111111101110001011100111001011110110110111011000110101
11110110010111100111000110101110101101001000101111101010001000011110011001111111000011111111100100010000100001000111011001110011000010011110001111110010101
11010010110000001101111110100100100001011110001000100010111011110000111100100001101110000011001111011110111111010100001011100111011111000100100000000110001
10011000100111111000110000110101111100010111111011101010011111000111100110101011001000111010011110010110001000011111100010001101000101110101110111010111101
10111111101110000010000111110100001110110100001001001111110001011100001110001110011010001000111100110011011011110001111010111100010001000111010011111100101
10110010001011111111011110100110100011100001100011011000100101000101111011100100111111101111111001111010001000110101000010000111111011011100011010000001101
10011000111000011000010000001111111001001011110111001010001101010100001000110101100001000000110011101010111110100101111011110001100010010001001000110100101
11010011101101001011111101111011011101011001010001101011111101110101100011100100001101111110100110000010000010001100110010011101001010110111101110100101101
10010110000001101001001100100001010101111111000101101000011000100100110110001111111000000010001110111111010111111110011000110100011010010010100011101101001
10110011011111101101100110001100000100111100010100101101001110001110010000111010101111111010111000110001110100001111001111100111001111011010111001000101011
10111000010000100001110011011111010110011001110110100111100011111111011111100000001010100010011010010100100001100101101000001101100101001010101101010111001
10101111110111111111011010000011010010110011010011110010111010000110001000001111100010001111010010110110101100110000100010100001110101011010001101010011101
10000110000100001000000010111001011110010111000111000110000011010011101110111010111010111000010110010110001001111111111110111011000101000000111001011001001
11010011010001011011101000101101000011010010011100011100111110011000100110100010001010011101110110110011101111000110000010001110011101101111100011011101011
11011010011111001010111111100111111000011010111001001001101011001110110010101000111011000100000100011000111100010000111011101000110000111000001110010100001
10001110110001101010010001110010001111111010101011101011000001100011111000101011100001110111111111011110001001111101100011001010000110010011111100110111111
10111000100101101011000100111000101010101010001010111001111100111010001111101110001111010011001010000111100011000111110110011011111111110111000110100000001
10110011101100101011101101100011101000100011011010100011000110000010100000001100101000011001100000110001111110010000000110110001100000100110010100111101011
10100111001110001010101000111000100010001001110010101110010011110110111101111001111101011101111111111101000100111111110010100111001110001100110101100001001
10101101011011101000001110001111111111111100000110100010111010000100000100001011011001010101010001100100010101110001000110101110011011111001110001001111011
10000101011011001111111011101100001100010111011100111000100011010101111111101001010011010101000100110001111101000100011100101100110011001011011111011101001
11110101001001011100001000100001100101000110001110011111101010011101011000101100010111010100011110011111000101011111110101100101111010011010000000000101101
11000001101100010001011010111111110101011100101011010000101111000101000010101111000101000111110111000010010101010000000101110100011000110010101011110100101
10011111100101110111001010110011000101001001101000000101101101101101111110100001111101110100000001111000110001000111110100000111001101110111111000010110001
11111000110100010001011010010110011101101111101111011111001001000101000100110111100001100101111100101111111111111100000111111101100100010100001110110100111
10001010000111011101010011000010110000100010000010011000011011010101010001100010110101001100110110000010000010000101111101000000110111000110100011100101101
10100011111110001101010111111010100110111010111000110011111011010001011111111010000111011110010011011000101010110100100001011110010001110110110110001100001
10110110001100100111010010001000101100101010001111110110000010011111010000000010101100010011000110011111111010100110001101001011011101100010100100111111011
10011100100110110011011000111111111101100011011000100100101110110000010111010110100001111001110111000000010010101111111001101001010100111000101101100001001
11000001110011111000001010010101000101001111110010101101100110100111110011011100111111010011010011111111011010100000110011101011000110011111100001001111011
10011111111000001111111111010000010001011101000110100111110000110000011001110001110001000110011001100011001110111011100110001000011111000001111111100110001
10110000101110100100000110011011110101000001101100110001100101110111011100010111000101101100111100111001100100001000001111011111010001111100000010110000111
10111010000100101101011100111000111111111100101001111011001100011100010110110100011100000101100110001100110001111111111000010110010100000111101000011110101
10000010101101111001011001101010001110000110101011110010011001010001000010010001110111110001110111011110011111010000000011010000110101101110111111000010001
10101111111001100011001011100011100100110010001010100111111111000101111110111111010000110100010101001010111001000101011010011111100111000010010001111011101
11111000010011001111101000111000110101111011101010001100000001110111000110110010000110011111010001100000001011011111011011111000101100011011000100001000111
11000011000110011001101110001110100101001000111010100110111100100010010010011000111111001100011011111111101000000011001110000010100101111011011110101110001
10011111111110111101000111100011101100011101110011110010001110111110111011001010010001111001010000010001001011111001100011011110101100110010001010100011101
10110001100010011001010010111011000101110000011000011011011010001000100011100010110100001011110110110100011010001100110110000010000110010110100010111011001
10100100001011001011011000110001010100111111001101001000001011101011101110110111100111101010100100010111111110100111100010111111110111010011101010010001011
10001111111001101001001110011101011110011001100111101110100000101010100100000110001100100010001101110101000000110001101000001000100011011001111011011011001
10111101000011101011100011001101000011001101110110000011110111101000110111110100111110111111011101100100011111111100101101101010111010001100001110010001101
10000001011010101010111001111001110111100100010011111000110100001110110001000101100100000001010001001110110001101110111000111010100010111111100111011101101
11111101001010100010001100110011100011110110111000011010011101111010011101011101110001111101010111011010000100100010001010110010111010101010110101000111001
10000111101000111011011110010110101001010110001111001011000100001010111001010001000101000100010001000011101110111011101011100110001110100000010001010001011
11010010101110110010000011010110001100010100100001101111110110100000100011000111110101010111111101111000101000110000101111001111100100101111011101011101001
10011000100110100110111001000100100111110101101100100101100010111111101111011100010100010011000111001110101011100101100010011000110110100011000101110001101
10111110110010101110001101111101110100010111000110110001001010110001001010010001011101111010010001100110111001001100111000110010010010101001111100100100101
10001100011010101011101000110100010001000010011100011101111010010100011000110111001001001000111100110000001101011110001111110111011000101100000110001111101
10101001000011101000001010010110111111111011111001000100010011110111111011100011101100011111110110011111101001010000111100000100001111101111110011100100001
10101111111010001101101011010010011000101000110011110111010111000100001010001001100110110001000011001100100011011111100001011111111000000000010110110101101
10100100001110111001101110011000110010101110010110100101010001011110100010101100110010100100011011101001111110000100001011000100011010111111010000100100101
10110101101000011100111100110011100110100111010010001101011100010010111111100110011010001111110000100011000111110101111111110001001011100011010111101110101
10010000100011110110000101111111001110110000011010111001000110110110000000110011010011011100011110101001010011000100010100011101100010001010010000101010111
11011111111110000011110101000000011000100101010010011101110111100011111110111110010111010001010000101100011010011110110001011000110110111011111101101010001
11010101101000111000000101010111110010111111000111010000010011001000000010010000110110010111011011100111110010110000100111001010011100100011000100000011101
10010000001101101111111101010010100111100001111111010101111001111101111011000111100100110100001001101110000110010111101101101111001101101110010111111010001
10111110101101000000001001011010101101001101000110010100011100011000001001111101101110110111101100100100111100110010001000100101111001001000110110001110101
10000010100001011010111011011010001000011001010100110101000111001010101011101000001000100110100111110110001001100110111110110000100011101011100000100000101
11111000111111010010011010010010111011111011110101111111101101101111101000100011111010101100110000010011101101001100100000111110001010000010111011111101101
10101111100001010111010011110110000010000010000100100011000001100101001010001110001111101001111111011010100101011001101110100011011111111010010010000111001
10001100001011010100010110000111111111011110111110001000010100110001111011111100100110001100010000011010110101001011100111101010001100001111010110110010011
10100101111110010101110100110010001100010010000111111111111110111100010001000110110100111001010111110010000001011000110001101000101001100101000010011011001
10110001000000110111000110111110100101111000110000000110001010100111011100010100100001100011110110000111111101001110010100001111111011110001111011001001111
10110111011111110100011110010000110100011011111111010000100010110001000111110101111111101111000100101110001001100111011110111000000001100100011011101100001
10100100010000010001010011000111100110110001000001111110111010111101110010100001010000100101011101101100101011110001000010001101111100111111001010100111101
10110101110111011111111010011100101110011011011101100011100010001100011010001111000110110001010111001001101110010111111011011001000110011001101010110000101
10100101010100001000100010110001100011010001010000001000110111101001001011011101011100011101000011101011000011010010001001110011011111000011001000011101101
10111101000101100010101000000100111010010111010111111110100000001111101001110001000111000001111010001001111001011010101100100110001101101110011101110001001
10000001011100111110101111111110011011010110011100101000101111100011001100011011010001111111010000101011001100010011100110001110100100111000110111000101011
10111111010110001000100110000011001010010010111001100011101000101001100111001010011011000011000111101001011001010111001111111010110001110010110110010111001
10001101000011101101110010111001111011010110100011001110111010101100110101101000111010011001101101101101001101010001011101000000111101100110000100111100011
11101001111010001001010110101100001001010100110110011000000010101110010000101101101000111100001000111101100111011101000001111010101001001111111101100001001
10101011011010111100011100100111101101011101110010111111110110111011011011100101101111110111111010011001110011011001110100001110001011011100001100101111101
10001000000010010111000001110101001001011001011000011000000100001010010001110101000100010000110011010011011001001011000111100011101001010110101001101001101
10111111111111010001111111010100011011000011010011000011011111101010110101000101010101010101100110010110011101101011011101111000111101000000101011001101001
10000000000010010100000000010001010001010110000111111001110001001010111101011100010001000100110110110011000001001000010100001110000101111111100010011101011
11111111111011011111111011110111111101111100110100011101100100011010100001001111111111110110011100011001111101011111110001011011110000100010111110110101001
10000100011010001100010000010010110001000111100101000111001111110010101011100000011000010011000101001100001101011000000111001000111110001010001000100001101
10111101001010100001010110111010000111010011001101110001101010000110101000111111001011010111110001111111100001001011111101101010000111101000111011101100001
10001001100011101111010010000010101100011001111100011100100011011100111010000101100011010100010111000001111101100000001001101011110000101101100010000111111
11101011111111000100011011111110100001111100000111000110111001000101110011010001111110010101011100011101000000111111100011001010011011101111001111110100001
10001001000100011101111010010000101011000111010101011110101101110000011110011100110010110101001001110100011111100000110110011010110011000100011001100110111
10111101011101010100100010110111111010011101010001001000100100110101000011000110100110011101100011000101110000110110011100110000011010011101111100001100001
10011001001101110110110110000100011011000001011111101011101110011111101001101100001111011000111110010111100101100011001001100111110010110001010101111001101
11001011100000100100100111111101010001101011011000001010000011001010001100111001100101000010000000110010001100101111100011001100000110010111000100001111001
11101000111010001101110100000101010100001110010011111010101111100011011110100011110001111111111110110110111110100101111111011001110011010101010111011000011
10001110001111101100010111010001011110111000110110110010100001111001111100001111011101100010000011100010100000110000100010010011011011010100010101000011001
11100011100010000111010010011111001100011101100000100110110100101100101001011100000111001010111000101110110101100110001000110110000010010110110001111001101
10001000111010111100011010111001100101110000111010101100010110100110001011010001110000011000101110100010011101111111111111100011011110110010011111101100111
10111110011010000110110000101100110101100110100011101001010010001111101111010111011111111111100110101111001000000010000001001110000100011011000010101110011
10100011001011101100111110100101100100101111101110001011011011101101100100010011000000110000001100100101101110111010111100011011110101110010011000001011001
10001001111000111001100011110001001110100010000011011110001001000100110101111010011010010111011001110100100011100010001111110001100100111010111111100001101
10111100001110001011001011011011011000101000111110010100111101010110010100110010110011010001110011100001101000111010100001100100101110010010101000101111101
10000101100011101000011001010000010011111111100000110101100101110111010110100111100111010100010110001111111110110011101100110110100111010110000011101000001
11011111001011001110111101000111111000010100001111110100110101100000010111101100001100011111010010111010000010011000111110011100001100010011101110001011101
11110001101010011100000101110110001111110001111101000101100100111111010011000110111101111000011010100010111011001110011111001001111001010110000100101010111
10000100111010110001110100010100100010000111100000010100110110010001011000011100010000000011011010111010010001101011001101101111000011010011010101111010011
10111110000010111111010111010001111010111100110111110110110011000101111111110101010111111110001010001011011100001001101000100000011111111001111100100011001
10000111111010000001000010010111000010100110010110010110011011111100110010110001011110000111111010100001000111111100100010111101110000001101000001101111101
10110010001111111101111110111100011110110011000011000011000010001110011000011101000100110000011010111111110100110001111110000111000111101001011111001000101
10011010101000101000011000101001001000111010011001111111111000100011000011001001010001111111001011100011000101100100000111010011101100100011000011011010001
11001000100010000011000010100011100010100000111100000000000010101001010111100011010100000001100000001000010100001101010000011000000110001010011000000010100
11111111111111111111111111111111111111111111111111111111111111111111111111111111111111111111111111111111111111111111111111111111111111111111111111111111111
