11111111111111111111
00010000101010101001
10111101100010000011
10001001101010110111
11101011001000010001
10101010011111110111
10001000111100010011
11011111111001011001
10000000010011001101
11111111010111100101
10000110010101110001
10111100110000011101
10001001100101010001
11011011101111011101
10000010000011000111
11011111110110010001
10010100011100111011
11010001000111100001
10000101010000001100
11111111111111111111
