11111111111111111111111111111111111111111111111111111111111111111111111111111111111111111111111111111111111111
00010000101010000001000100001000101000000000010000000101000000001000010000000110001000000000101000100010001001
10110110000011110101101101100010001011011111110101110001011111101011000111110011100010101111100010001011100011
10000011111000100100100000110110100001110001000100011101000110101001110100011001101110100110001111011001110111
11111110001110110110101111100100110101100100011110110001010010101100010001001100100100101100111101001100000101
10000011100010000100100110101111110111001111111000100111111010101001011011100110110101111001100001011111110001
10111001001011111101110100100001100110011010001011101110100010001111110010110110100100000011101101000100111101
10011100011110001101010001101100111100110000100010101000001110111100011110000100111111011111001001110101100001
11001110110000101001011011001110011001111011111110001101111010100001011000111110110001000010011011010101001111
11100010000101101011000001111011000011100000100000111101000010001111001011100000000101111000110001010100011101
10111011111111001011111100110001111110111110110101101001101111111001101000111101111100011111110100010110111001
10101010000011011000110110000101101100011010011100100011100100001011101010000111000101000001000111110010110011
10100010101110001110100011111100100111010011000110001110110001101000001011110010011111111101101100011010000111
10001111101000111100101000101110110000000111110111111000010111001011111011011011000010001001001001011011110001
10111000001011110001101111100000111011010010110100000011010001101000101010011010011000101011011011000010110111
10101111011000100111001100001011100011111000100111111110011101001110001000110010111101111010010011111110000011
10001100011110001101100001011000111000011110101100000111000001011011101111110110100101010011110110000011101001
11100001000110111000111111111110001111000110100101110011110111000000100110000100001101000110000110111000101101
10111111110011101110000000100111100001110010110001011000010011111011110000110101011001011100110010011110111001
10100000011001000111101110110000111100111011111111011111011010001000011111111111110011010110100111001010001101
10101101111101010011001010011101100110011000010101000010010000101101111001011010000111010000101101101011100111
10100100001001011010011011001100001111001011000100011010110110100100001100000010101101011011101000100000110001
10001111100011001010110001100111101011101011101101111010011100110110111001101000111000010011000010110111111011
10111001111111101010100111110001100001101000100101001011000111110010001011101101110011111001111011100100011001
10011100001000001000110010111100110101001111101101101001110000011011011010101101000110001100010001001101001011
11001001011011101111111010000110011101011000100101001100011111001110010000100101011100100101011101011001101001
11101011000010100110011000110011001101000010110001011110111011100110110110110101000101110111001111010011101011
10101011011110110010110010111001100101111110010100001100001000110010000011110111110001010001100100010110001001
10101110000000011010100110001100110101010111011111100110101110011010111110000100011111011100110101110110111101
10001100110111111010101100100110100100000010010000110100101100110010000010111101000001010110010001000100100101
11011001111100000010101101111100101111111010111010111101100001100111111010000001101101000011010111011101110001
10001011100001011110100111000001100000011010100010000101111111110110000011111111100111011000010110010101010101
11101111001011110000110010011100111111001010110111110100011000110011111001000000101100011111111100110101010101
10000110011000100101110110110110000101101010010100010101001010011000001101111010100110110000101001110101010101
11110011111110101100100100100010110001001011000110110101100011001111101000000010110010000110000011000101000101
11011000011100111110101101111010011011011001111110010111101110011001001111111110011011111111111110010101111101
10001111001001100000100100100011001110011100000000110011001000111101011000100011011000011000100011011100110001
10111001100011001011110110101111011000110001101011111001101010001101001110001000001011010010001110000110000101
10001011111110011001100110100010001011100100111110001100111011100001100011111111101001110111011100110011111101
11100000000111011101001100101000111000111110010100100110001000110111111000010001101101100001001001110111011001
11001011101100001101011001101101101110000111000001110011101101111100011101000100100100001101011011010101010011
10011010101001100111010011000111100011110001010111000111000101101001000111111110110111111101001000010000000111
11010010101011110000010111010011001000111101111100010001110100101011110110000110100001000111101101111111111101
10010110101000111111010001111001011110010001000110111011010110001001000000110010101101010100000100101011000001
10110100101110010001111100011101010110110111010010001010010011011101111111111000100111010001101110000010010111
10110101100011010100101110110100010100100110011011101000111001000100010000101111110100011011111011111010110001
10010100110110010110000010010111110001101100110010001101101101011111000110100000010101001110000001010010011011
11010101100100110010110111010001000111001001110111011100000101001011111110110111000101111000101100010110111001
10010100101101111111110011011011011100011011000000010101110101100010001000100011111100010010101111110011100011
10110110001000110001000110010000000110110011101101010000111101001010101011101110100110110111100000111011001001
10100100111011100100010010110111101100111000111111111110100001011010100011000010001110010101111110001000011101
11101111110010001101111110111110000101101110100010100011101111010010111001111000100011000001000111101111111001
10001010000111011111000010001100110100000010001000001011001000011010001100110011111110011101110001000001000011
10111000111101000010010111101001111110111010101111111000011111001111100110011110000110110000111101011011011111
10000011110000011000110101101101100011101011100101101111110001101101001111001000110011100110000001001110011001
10111111010101111101100000100111001001001001110001000010000101101001011100011011111000111111111101011000110011
10010001010111000111111110110000011100011100111100011010101100000011010101110010001110001001000101001101100111
11000101000010010000001000111111110111001110101001110011101001010111010001100110100111100011010101100100101101
11111101011110111111101011100011010001100110001111010110001111111100010111001100110001111010010111110110100001
10100001010000100010001000001001000100110011100001000000111000010001110011011110111100001010110010000100111101
10001111010111101000111011011101010110011010111101111111110011000111000110010100001110101000011010111101110001
10111000010010001111100010010001011100110000000100100001100111111100010100110101101000101111110010011001000101
10011111011011011001101110111011110001100111111110101100101101100101111101110000111011100101011011000011011101
11010001110010001011000110101000110100101100000010100110001000110000010001011110110010110100001001110110011001
11010100010111101001011100101110000110101001111000110011101010110111110111001100010110010101101100010111010011
10000101000110001101011001101011111100100011101111111001111010010010000011100001010111010111000111010000010111
11111111111100111001001011000001100001111110000110001100110011011010111110111111110001000110011101011111110101
10110011000101101101101001101100001011110000110010111110000111001110110000001100010101110000111001010001100001
10000110010001000000101100111001111111100110011000100000111101100000100101101001011100011110010011000100110101
11011100111111111010001110001101000011001111001101101111101000111111101111000011011001000111000111111110011101
10011001100000110010111011100111011000011110011111001000001110000110100001111110001101110100010100000011011001
10110011101010011110100000110001011101110100110000011011100111110000101101000111100111100101011101111001001111
10010110001011000100001111110100010001000111110111111010110000011011100100010001110000101111111001001101100011
10110000111111110111101000011110110111010000010001100010111111011001001111111100111110001000110011011001001001
10111111110110010010001011000011100100011101010100110110000010010011011000100110000111101010000110010011111101
10000000010100111010111001111001110001010001011110010011101010110110010010001111110001101010111111000110000001
10111101000001100010001101001100011011110111001011010111001110100100111011100001011100111011100001011100111011
10000111111011001110111001101111010001100101101000010001011100101101101010111101000110001000101101000001100001
10111100001001011000100011100000011111001101001011111101000101100001000010000001010111011101100101111111111101
11100001101101001110101010001010110001011000011010101001011100111011101111110101010010001101110100110000110001
10001111000101100011101111111110000101001101111000001011000110010000000100011100011010100100110110010110011011
10111000010000111000100101000110111101100100101111100011101111011011111101000111111110101110000011010111110001
10001111111111101110110001010011100001110110100000111110000001001110000101110001100000111011111111010000100111
11100000000000000100011011011011001111000111101110010111010111101000110100111100001110010000100110011101101101
11001111111111010101110011001001011001010011000011010001011100000010100110101111111011010110001100110000100101
10011101000010010100100110011101011101011000011001000100010001110111110000100011010001000111011001100110110101
10111000011010111110101100110001001100001111111101111110110111011100011010101001000111010011110011110011110001
10110011111010000000100001110111100111111000111000000010100100010001001111101101010001111010100110011001011011
10100110100011111111101111000100110000001010010010111110101101010111101000111001011100100000101111011100001001
10001100101110000110111000011101111111100011010110100010100001010110000010100011000110001111101010000101101101
11111001101000110000010011110100010110111110010011101000111111010011111110110111110111111101100011110001100101
10110011101011111011000111010001000010001010111001101111100011011001000100100100100100000100111000100100110001
10100110001000110011111100010111111000100010011100100000110110001101011101110001101101110110001110101111100101
10001100111111100110101001110110101111111011001101111110010000111101001100011100001001010100101010111000111101
10111101100000001110100011100000000000001001100111000011010111100001100111000101111011000001100010100010001111
10011001101101111010001000001011111111101100110011011011000001001111110101110101001010010101111110001111100011
11010011001001011000111111111110001100001001111000010001110111011010000001100101100010111111000110111001111001
11000110011011000011101000110000100111111011001111111100100010010000101011001100110111111000010100001100101101
10011111110010011110001010100111110010000010011100001110101110110101111110011110010001110011110101100110001001
10110001100111010000101110101110011000101000110001101000101100100100010000110011011100100110010111110011011011
10100100101100010101100000100011001101111110011111101011111001101101110111111010000110101100110100011000001001
10110110001001110100111111111011101111010110110001001000010011100100000011000011110100100110010001001101011011
10100111111011011110000000001010000110010000000101011111011010110111111110011011000001110100111111100111110001
10110001010010000011111101101011010000110111110100000001000010010010001100111001111011100101110000110010000101
10011101000110101000000111001001010101100100011110101111111111011000101001101100001110001100010101111011101101
11010001011111101111110011011101110100001101001100111000010001011111101011101111100110111001000101011001101001
10010111010001001000011001000100011111111101100110010010110100000010001000101000110010101011111100001100101011
11000101010101011011001101101111000010000101110011110110010111111010111110100010011010100010100101100110101001
10010100000100010001100000000001011000110000011000000011000000001000000000101011000000101000001100110000001100
11111111111111111111111111111111111111111111111111111111111111111111111111111111111111111111111111111111111111
